30,21,14,10,0
------------787878787878787878------------------------------
--------7878788383838383838378------------------------------
------78787A050505050505050578------------------------------
----78780505050505050505050578------------------------------
--7878050505050505050505050578------------------------------
--780505050505050505050505057841----------------------------
--78050505050505050505050505784141--------------------------
787805050505050505050505050578414141------------------------
780505050505050505050505050578414141------------------------
780505058C05050505050505050578414141------------------------
780505FE8C05050505050505050505414141------------------------
780505058C05050505050505050578414141------------------------
780505050505050505050505050578414141------------------------
787805050505050578787878787878414141------------------------
--7805050505050578050E0E0E78784141--------------------------
--7805050505050578050E0E0E787841----------------------------
--7878050505050578050505057878------------------------------
----78780505050505050505057878------------------------------
------78787A050505050505057878------------------------------
--------7878787878838379797878------------------------------
------------787878787878787878------------------------------
