60,21,39,8,0
------------78787878787878787878787878787878787878787878787878787878787878787878----------------------------------------
--------7878780505050505050505050505050505050505050505050505050505050505050505787878------------------------------------
------7878050505FE0505050505050505050505050505050505050505050505050505050505050505787878--------------------------------
----787805050505050505050505050505FE050505050505050505050505050505050505050505050505057878------------------------------
--7878050505050505050505050505050505050505050505050505050505FE05050505050505050505050505787878--------------------------
--780505050505050505050505050505050505050505050505050505050505050505050505050505050505050505787878----------------------
--78050505050505050505050505050505050505050505050505050505050505050505050505050505050505050505057878--------------------
78787878787805050505050505050505050505050505050505050505050505050505050505050578787878787805050505787878----------------
78414141410505050E05050505050E05050505050E05050505050E05050505050E050505050505054141414178050505050505787878------------
78414141410505050EFE050505050E05050505050E05050505050E05050505050E050505050505054141414178050505050505057878787878------
7841417878780E0E780E0E050E0E780E0E050E0E780E0E050E0E780E0E050E0E780E0E05050505787878414178050505050505057878787878787878
7841------7805050E05050505050E05050505050E05050505050EFE050505050E05050505050578------4178050505050505057878787878------
78--------7805050E05050505050E05050505050E05050505050E05050505050E05050505050578--------78050505050505787878------------
78787878787805050505050505050505050505050505050505050505050505050505050505050578787878787805050505787878----------------
--78050505050505050505050505050505050505050505050505050505050505050505050505050505050505050505057878--------------------
--78050505050505050505050505050505050505FE05050505050505050505050505050505050505050505050505787878----------------------
--78780505050505050505050505050505050505050505050505050505050505050505050505050505050505787878--------------------------
----78780505050505050505050505050505050505050505050505050505050505050505050505050505057878------------------------------
------7878050505050505FE05050505050505050505050505050505050505FE050505050505050505787878--------------------------------
--------7878780505050505050505050505050505050505050505050505050505050505050505787878------------------------------------
------------78787878787878787878787878787878787878787878787878787878787878787878----------------------------------------
