60,21,5,11,0
------------7878787878787878787878787878787878787878--------------------------------------------------------------------
--------787878050579797979790579797979790505050505787878----------------------------------------------------------------
------787805050505050505050505050505050505050505FE0505787878------------------------------------------------------------
----7878050505050505050505050505050505050505050505050505057878----------------------------------------------------------
--7878797979797905797979797905797979797905797979797905050505787878------------------------------------------------------
--78050505050505050505050505050505FE0505050505050505050505050505787878--------------------------------------------------
--7805050505050505050505050505050505050505050505050505050505050505057878------------------------------------------------
7878787878780505057979797979057979797979057979797979057979797979050505787878--------------------------------------------
78--------7805050505050505050505050505050505050505050505050505050505050505787878----------------------------------------
7841------7805050505050505050505050505050505050505050505050505050505050505057878787878----------------------------------
78414178787805057805FE05050578050505050578050505050578050505050578FE050505057878787878787878----------------------------
78414141410505050505050505050505050505050505050505050505050505050505050505057878787878----------------------------------
78414141410505050505050505050505050505050505050505050505050505050505050505787878----------------------------------------
7878787878780505057979797979057979797979057979797979057979797979050505787878--------------------------------------------
--7805050505050505050505050505050505050505050505FE0505050505050505057878------------------------------------------------
--78050505050505050505050505050505050505050505050505050505050505787878--------------------------------------------------
--7878797979797905797979797905797979797905797979797905050505787878------------------------------------------------------
----787805050505050505FE05050505050505050505050505050505057878----------------------------------------------------------
------787805050505050505050505050505050505050505050505787878------------------------------------------------------------
--------787878050579797979790579797979790505050505787878----------------------------------------------------------------
------------7878787878787878787878787878787878787878--------------------------------------------------------------------
