78,58,-1,-1,0
0A0A010145454545454545454545454545454545454545454545454501010A0A00000000000000000000000000000000000000000000000000000000000000000000000000000000000000000000
0A0A0A01010101010101010101010101010101010101010101010101010A0A0A00000000000000000000000000000000000000000000000000000000000000000000000000000000000000000000
010A0A0A0101010101010101010101010101010101010101010101010A0A0A0100000000000000000000000000000000000000000000000000000000000000000000000000000000000000000000
01010A0A0A0A0A0A0A0A0A0A0A0A0A0A0A0A0A0A0A0A0A0A0A0A0A0A0A0A010100000000000000000000000000000000000000000000000000000000000000000000000000000000000000000000
4501010A0A0A0A0A0A0A0A0A0A0A0A0A0A0A0A0A0A0A0A0A0A0A0A0A0A01014500000000000000000000000000000000000000000000000000000000000000000000000000000000000000000000
450101010A0A450A0A4747474747470A0A4747474747470A0A450A010101014500000000000000000000000000000000000000000000000000000000000000000000000000000000000000000000
45010101010A450A0A4747474747470A0A4747474747470A0A450A010101014500000000000000000000000000000000000000000000000000000000000000000000000000000000000000000000
45010101010A450A0A4747474747470A0A4747474747470A0A450A010101014500000000000000000000000000000000000000000000000000000000000000000000000000000000000000000000
45474747470A450A0A4747474747470A0A4747474747470A0A450A474747474500000000000000000000000000000000000000000000000000000000000000000000000000000000000000000000
45474747470A450A0A0A0A0A0A0A0A0A0A0A0A0A0A0A0A0A0A450A474747474500000000000000000000000000000000000000000000000000000000000000000000000000000000000000000000
45474747470A450A0A0A0A0A0A0A0A0A0A0A0A0A0A0A0A0A0A450A474747474500000000000000000000000000000000000000000000000000000000000000000000000000000000000000000000
45474747470A450A0A4747474747470A0A4747474747470A0A450A474747474500000000000000000000000000000000000000000000000000000000000000000000000000000000000000000000
450A0A0A0A0A450A0A4747474747470A0A4747474747470A0A450A0A0A0A0A4500000000000000000000000000000000000000000000000000000000000000000000000000000000000000000000
450A0A0A0A0A450A0A4747474747470A0A4747474747470A0A450A0A0A0A0A4500000000000000000000000000000000000000000000000000000000000000000000000000000000000000000000
45010101010A450A0A4747474747470A0A4747474747470A0A450A010101014500000000000000000000000000000000000000000000000000000000000000000000000000000000000000000000
45010101010A0A0A0A0A0A0A0A0A0A0A0A0A0A0A0A0A0A0A0A450A010101014500000000000000000000000000000000000000000000000000000000000000000000000000000000000000000000
45010101010A0A0A0A0A0A0A0A0A0A0A0A0A0A0A0A0A0A0A0A450A010101014500000000000000000000000000000000000000000000000000000000000000000000000000000000000000000000
4501010101010101010101010101010A0A01010101010101010101010101014500000000000000000000000000000000000000000000000000000000000000000000000000000000000000000000
4501010101010101010101010101010A0A01010101010101010101010101014500000000000000000000000000000000000000000000000000000000000000000000000000000000000000000000
4545454545454545454545454501010A0A01014545454545454545454545454500000000000000000000000000000000000000000000000000000000000000000000000000000000000000000000
000000000000000000000000000000000000000000000000000000000000000000000000000000000000000000000000000000000000000000000000000000000000000000000000000000000000
000000000000000000000000000000000000000000000000000000000000000000000000000000000000000000000000000000000000000000000000000000000000000000000000000000000000
000000000000000000000000000000000000000000000000000000000000000000000000000000000000000000000000000000000000000000000000000000000000000000000000000000000000
000000000000000000000000000000000000000000000000000000000000000000000000000000000000000000000000000000000000000000000000000000000000000000000000000000000000
000000000000000000000000000000000000000000000000000000000000000000000000000000000000000000000000000000000000000000000000000000000000000000000000000000000000
000000000000000000000000000000000000000000000000000000000000000000000000000000000000000000000000000000000000000000000000000000000000000000000000000000000000
000000000000000000000000000000000000000000000000000000000000000000000000000000000000000000000000000000000000000000000000000000000000000000000000000000000000
000000000000000000000000000000000000000000000000000000000000000000000000000000000000000000000000000000000000000000000000000000000000000000000000000000000000
000000000000000000000000000000000000000000000000000000000000000000000000000000000000000000000000000000000000000000000000000000000000000000000000000000000000
000000000000000000000000000000000000000000000000000000000000000000000000000000000000000000000000000000000000000000000000000000000000000000000000000000000000
000000000000000000000000000000000000000000000000000000000000000000000000000000000000000000000000000000000000000000000000000000000000000000000000000000000000
000000000000000000000000000000000000000000000000000000000000000000000000000000000000000000000000000000000000000000000000000000000000000000000000000000000000
000000000000000000000000000000000000000000000000000000000000000000000000000000000000000000000000000000000000000000000000000000000000000000000000000000000000
000000000000000000000000000000000000000000000000000000000000000000000000000000000000000000000000000000000000000000000000000000000000000000000000000000000000
000000000000000000000000000000000000000000000000000000000000000000000000000000000000000000000000000000000000000000000000000000000000000000000000000000000000
000000000000000000000000000000000000000000000000000000000000000000000000000000000000000000000000000000000000000000000000000000000000000000000000000000000000
000000000000000000000000000000000000000000000000000000000000000000000000000000000000000000000000000000000000000000000000000000000000000000000000000000000000
000000000000000000000000000000000000000000000000000000000000000000000000000000000000000000000000000000000000000000000000000000000000000000000000000000000000
000000000000000000000000000000000000000000000000000000000000000000000000000000000000000000000000000000000000000000000000000000000000000000000000000000000000
000000000000000000000000000000000000000000000000000000000000000000000000000000000000000000000000000000000000000000000000000000000000000000000000000000000000
000000000000000000000000000000000000000000000000000000000000000000000000000000000000000000000000000000000000000000000000000000000000000000000000000000000000
000000000000000000000000000000000000000000000000000000000000000000000000000000000000000000000000000000000000000000000000000000000000000000000000000000000000
000000000000000000000000000000000000000000000000000000000000000000000000000000000000000000000000000000000000000000000000000000000000000000000000000000000000
000000000000000000000000000000000000000000000000000000000000000000000000000000000000000000000000000000000000000000000000000000000000000000000000000000000000
000000000000000000000000000000000000000000000000000000000000000000000000000000000000000000000000000000000000000000000000000000000000000000000000000000000000
000000000000000000000000000000000000000000000000000000000000000000000000000000000000000000000000000000000000000000000000000000000000000000000000000000000000
000000000000000000000000000000000000000000000000000000000000000000000000000000000000000000000000000000000000000000000000000000000000000000000000000000000000
000000000000000000000000000000000000000000000000000000000000000000000000000000000000000000000000000000000000000000000000000000000000000000000000000000000000
000000000000000000000000000000000000000000000000000000000000000000000000000000000000000000000000000000000000000000000000000000000000000000000000000000000000
000000000000000000000000000000000000000000000000000000000000000000000000000000000000000000000000000000000000000000000000000000000000000000000000000000000000
000000000000000000000000000000000000000000000000000000000000000000000000000000000000000000000000000000000000000000000000000000000000000000000000000000000000
000000000000000000000000000000000000000000000000000000000000000000000000000000000000000000000000000000000000000000000000000000000000000000000000000000000000
000000000000000000000000000000000000000000000000000000000000000000000000000000000000000000000000000000000000000000000000000000000000000000000000000000000000
000000000000000000000000000000000000000000000000000000000000000000000000000000000000000000000000000000000000000000000000000000000000000000000000000000000000
000000000000000000000000000000000000000000000000000000000000000000000000000000000000000000000000000000000000000000000000000000000000000000000000000000000000
000000000000000000000000000000000000000000000000000000000000000000000000000000000000000000000000000000000000000000000000000000000000000000000000000000000000
000000000000000000000000000000000000000000000000000000000000000000000000000000000000000000000000000000000000000000000000000000000000000000000000000000000000
000000000000000000000000000000000000000000000000000000000000000000000000000000000000000000000000000000000000000000000000000000000000000000000000000000000000
