51,51,25,48,0
A1A1A1A1A1A1A1A1A1A1A1A1A1--------------------------------------------------A2A2A2A2A2A2A2A2A2A2A2A2A2
A12323232323232323232323A1--------------------------------------------------A22424242424242424242424A2
A12323232323232323232323A1--------------------------------------------------A22424242424242424242424A2
A12323232323232323232323A1A2A2A2A1A1A1A2A2A2A3A3A3A3A3A3A3A1A1A1A2A2A2A1A1A1A22424242424242424242424A2
A123232323232323232323232324242423232324242425252525252525232323242424232323242424242424242424242424A2
A123232323232323232323232324242423232324242425252525252525232323242424232323242424242424242424242424A2
A123232323232323232323232324242423232324242425252525252525232323242424232323242424242424242424242424A2
A12323232323232323232323A1A2A2A2A1A1A1A2A2A2A3A3252525A3A3A1A1A1A2A2A2A1A1A1A22424242424242424242424A2
A12323232323232323232323A1--------------------A3252525A3--------------------A22424242424242424242424A2
A12323232323232323232323A1--------------------A3252525A3--------------------A22424242424242424242424A2
A12323232323232323232323A1--------------------A3252525A3--------------------A22424242424242424242424A2
A12323232323232323232323A1--------------------A3252525A3--------------------A22424242424242424242424A2
A1A1A1A1232323A1A1A1A1A1A1--------------------A3252525A3--------------------A2A2A2A2A2A2242424A2A2A2A2
------A5272727A5------------------------------A3252525A3------------------------------A4262626A4------
------A5272727A5------------------------------A3252525A3------------------------------A4262626A4------
------A5272727A5------------------------------A3252525A3------------------------------A4262626A4------
------A1232323A1------------------------------A3252525A3------------------------------A2242424A2------
------A1232323A1------------------A3A3A3A3A3A3A3252525A3A3A3A3A3A3A3------------------A2242424A2------
------A1232323A1------------------A3232523252325252525252425242524A3------------------A2242424A2------
------A5272727A5------------------A3252325232523252525242524252425A3------------------A4262626A4------
------A5272727A5------------------A3232523252325252525252425242524A3------------------A4262626A4------
------A5272727A5------------------A3252325232523252525242524252425A3------------------A4262626A4------
------A3252525A3------------------A3232523252325252525252425242524A3------------------A3252525A3------
------A3252525A3A3A3A3A3A3A3A3A3A3A3252325232523252525242524252425A3A3A3A3A3A3A3A3A3A3A3252525A3------
------A325252525252525252525252525252525252525252525252525252525252525252525252525252525252525A3------
------A325252525252525252525252525252525252525252525252525252525252525252525252525252525252525A3------
------A325252525252525252525252525252525252525252525252525252525252525252525252525252525252525A3------
------A3252525A3A3A3A3A3A3A3A3A3A3A3252725272527252525262526252625A3A3A3A3A3A3A3A3A3A3A3252525A3------
------A3252525A3------------------A3272527252725252525252625262526A3------------------A3252525A3------
------A1232323A1------------------A3252725272527252525262526252625A3------------------A2242424A2------
------A1232323A1------------------A3272527252725252525252625262526A3------------------A2242424A2------
------A1232323A1------------------A3252725272527252525262526252625A3------------------A2242424A2------
------A5272727A5------------------A3272527252725252525252625262526A3------------------A4262626A4------
------A5272727A5------------------A3A3A3A3A3A3A3252525A3A3A3A3A3A3A3------------------A4262626A4------
------A5272727A5------------------------------A3252525A3------------------------------A4262626A4------
------A1232323A1------------------------------A3252525A3------------------------------A2242424A2------
------A1232323A1------------------------------A3252525A3------------------------------A2242424A2------
------A1232323A1------------------------------A3252525A3------------------------------A2242424A2------
A5A5A5A5272727A5A5A5A5A5A5--------------------A3252525A3--------------------A4A4A4A4A4A4262626A4A4A4A4
A52727272727272727272727A5--------------------A3252525A3--------------------A42626262626262626262626A4
A52727272727272727272727A5--------------------A3252525A3--------------------A42626262626262626262626A4
A52727272727272727272727A5--------------------A3252525A3--------------------A42626262626262626262626A4
A52727272727272727272727A5--------------------A3252525A3--------------------A42626262626262626262626A4
A52727272727272727272727A5A4A4A4A5A5A5A4A4A4A3A3252525A3A3A5A5A5A4A4A4A5A5A5A42626262626262626262626A4
A527272727272727272727272726262627272726262625252525252525272727262626272727262626262626262626262626A4
A527272727272727272727272726262627272726262625252525252525272727262626272727262626262626262626262626A4
A527272727272727272727272726262627272726262625252525252525272727262626272727262626262626262626262626A4
A52727272727272727272727A5A4A4A4A5A5A5A4A4A4A3A3252525A3A3A5A5A5A4A4A4A5A5A5A42626262626262626262626A4
A52727272727272727272727A5--------------------A3252525A3--------------------A42626262626262626262626A4
A52727272727272727272727A5--------------------A3616161A3--------------------A42626262626262626262626A4
A5A5A5A5A5A5A5A5A5A5A5A5A5--------------------A3616161A3--------------------A4A4A4A4A4A4A4A4A4A4A4A4A4
