95,95,79,15,0
----------------------------------------------------------------------------------------------------------------------------------------------------------------------------------------------
----------------------------------------------------------------------------------------------------------------------------------------------------------------------------------------------
----------------------------------------------------------------------------------------------------------------------------------------------------------------------------------------------
----------------------------------------------------------------------------------------------------------------------------------------------------------------------------------------------
----------------------------------------------------------------------------------------------------------------------------------------------------------------------------------------------
----------------------------------------------------------------------------------------------------------------------------------------------------------------------------------------------
----------------------------------------------------------------------------------------------------------------------------------------------------------------------------------------------
----------------787878--------------------------------------------------------------------------------------------------787878------------------------787878----------------------------------
--------------784141417878787878787878787878787878787878787878787878787878787878787878787878787878787878787878787878787841414178787878787878787878787841414178--------------------------------
--------------784141414141414141414141414141414141414141414141414141414141414141414141414141414141414141414141414141414141414141414141414141414141414141414178--------------------------------
--------------78414141787878787878787878787878787878787878787878787878787878787878787878787878787878787878787878787878784141417878787878787878787878784141414178------------------------------
----------------78417801010101010101010101010101010101010101010101010101010101010101010101010101010101010101010101010101784178010101010101010101010101787841414178----------------------------
----------------7841780101010101010101010101010101010101010101010101010101010101010101010101010101010101010101010101010178417801010101010101010101010101017841414178--------------------------
----------------784178010101000000000000000000000000000000000000000000000000000000000000000000000000000000000000000000007841780000000000000000000000000000007841414178------------------------
----------------78417801010000000000000000000000000000000000000000000000000000000000000000000000000000000000000000000000784178000000000000000000000000000000007841414178----------------------
----------------7841780101000000000101010101010101010101010A01010101010A01010101010A01010101010A01010101010A01010101010178417801010000000000000000000000000000007841414178--------------------
----------------7841780101000000000001010101010101797979797979797979010A01797979797979797979010A017979797979797979790178414141780100000000000000000000000000000000784141417878----------------
----------------7841780101000001000000010101010101797979797979797979010A01797979797979797979010A01797979797979797979017841414178010000000000000000000000000000000000784141414178--------------
----------------7841780101000001010000000101010101797979797979797979010A01797979797979797979010A01797979797979797979017841414178010000000000787878787878780000000000017841414178--------------
----------------7841780101000001010100000001010101797979797979797979010A01797979797979797979010A01797979797979797979010178417801010000000000783F3F3F3F3F780000000000017841414178--------------
----------------7841780101000001010101000000010101797979797979797979010A01797979797979797979010A01797979797979797979010178417801010000000000783F3F3F3F3F7800000000000101784178----------------
----------------7841780101000001010101010000000101010101010101010101010A01010101010101010101010A01010101010101010101010178417801010000000000783F3F823F3F7800000000000101784178----------------
----------------784178010100000101010101010000000A0A0A0A0A0A0A0A0A0A0A0A0A0A0A0A0A0A0A0A0A0A0A0A0A0A0A0A0A0A01010101010178417801010000000000783F3F3F3F3F7800000000000101784178----------------
----------------7841780101000001010101010101000000010101010101010101010A01010101010A01010101010A01010101010A01010101017841414178010000000000783F3F3F3F3F7800000000000101784178----------------
----------------78417801010000010101010101010A0000000101010101010101010A01797979797979797979010A017979797979797979790178414141780100000000007878787878787800000000000101784178----------------
----------------78417801010000017979797979010A0100000001010101010101010A01797979797979797979010A017979797979797979790178414141417800000000000000000000000000000000000101784178----------------
----------------78417801010000017979797979010A0101000000010101010101010A01797979797979797979010A017979797979797979790101787841414178000000000000000000000000000000000101784178----------------
----------------78417801010000017979797979010A0101010000000101010101010A01797979797979797979010A017979797979797979790101010178414141780000000000000000000000000000000101784178----------------
----------------78417801010000017979797979010A0101010100000001010101010A01797979797979797979010A017979797979797979790101010101784141417800000000000000000000000000000101784178----------------
----------------784178010100000A7979797979010A0101010101000000010101010A01010101010101010101010A010101010101010101010101010101007841414178000000000000000000000000000101784178----------------
----------------78417801010000017979797979010A0101010101010000000A0A0A0A0A0A0A0A0A0A0A0A0A0A0A0A0A0A0A0A0A0A010101010101010100000078414141780101010101010101010100000101784178----------------
----------------78417801010000017979797979010A0101010101010100000001010A01010101010A01010101010A01010101010A010101010101010000000000784141417878010101017878780100000101784178----------------
----------------78417801010000017979797979010A010101010101010A000000010A01010101010A01797979797979797979010A01010101010100000000000101784141414178787878414141787878787841414178--------------
----------------78417801010000017979797979010A010101010101010A010000000A01010101010A01797979797979797979010A01010101010000000000010101017841414141414141414141414141414141414178--------------
----------------78417801010000010101010101010A010101010101010A010100000001010101010A01797979797979797979010A01010101000000000001010101017841414178787878414141787878787841414178--------------
----------------784178010100000A0A0A0A0A0A0A0A0A0A0A0A0A0A0A0A0A0A0A000000010101010A01797979797979797979010A010101000000000001010101010101787878010101017878780100000101784178----------------
----------------78417801010000010101010101010A010101010101010A010101010000000101010A01797979797979797979010A010100000000000101010101010101010101010101010101010100000101784178----------------
----------------78417801010000017979797979010A017979797979010A010101010100000001010A01010101010101010101010A010000000000010101010101797979797901010179797979790100000101784178----------------
----------------78417801010000017979797979010A017979797979010A010101010101000000010A01010101010101010101010A000000000001010101010101797979797901010179797979790100000101784178----------------
----------------78417801010000017979797979010A017979797979010A010101010101010000000A010101010101010101010100000000000101010101010101797979797901010179797979790100000101784178----------------
----------------78417801010000017979797979010A017979797979010A0101010101010101000000010101010101010101010000000000010101010101010101797979797901010179797979790100000101784178----------------
----------------784178010100000A7979797979010A0A7979797979010A0A0A0A0A0A0A0A0A0A000000010101010101010100000000000A0A0A0A0A0A0A0A0A0179797979790A0A0179797979790A00000101784178----------------
----------------78417801010000017979797979010A017979797979010A0101010101010101010100000001010101010100000000000101010101010101010A017979797979010A0179797979790100000101784178----------------
----------------78417801010000017979797979010A017979797979010A0179797979790101010101000000010101010000000000010101017979797979010A017979797979010A0179797979790100000101784178----------------
----------------78417801010000017979797979010A017979797979010A0179797979790101010101010000000101000000000001010101017979797979010A017979797979010A0179797979790100000101784178----------------
----------------78417801010000017979797979010A017979797979010A0179797979790101010101010100000000000000000101010101017979797979010A017979797979010A0179797979790100000101784178----------------
----------------78417801010000010101010101010A010101010101010A0179797979790101010101010101000000000000010101010101017979797979010A010101010101010A0101010101010100000101784178----------------
----------------784178010100000A0A0A0A0A0A0A0A0A0A0A0A0A0A0A0A0A797979797901010101010101010000000000010101010101010179797979790A0A0A0A0A0A0A0A0A0A0A0A0A0A0A0A0A00000101784178----------------
----------------78417801010000010101010101010A010101010101010A0179797979790101010101010100000000000001010101010101017979797979010A010101010101010A0101010101010100000101784178----------------
----------------78417801010000017979797979010A017979797979010A0179797979790101010101010000000000000000010101010101017979797979010A017979797979010A0179797979790100000101784178----------------
----------------78417801010000017979797979010A017979797979010A0179797979790101010101000000000001010000000101010101017979797979010A017979797979010A0179797979790100000101784178----------------
----------------78417801010000017979797979010A017979797979010A0179797979790101010100000000000101010100000001010101017979797979010A017979797979010A0179797979790100000101784178----------------
----------------78417801010000017979797979010A017979797979010A0101010101010101010000000000010101010101000000010101010101010101010A017979797979010A0179797979790100000101784178----------------
----------------784178010100000A7979797979010A0A7979797979010A0A0A0A0A0A0A0A0A000000000001010101010101010000000A0A0A0A0A0A0A0A0A0A0179797979790A0A0179797979790A00000101784178----------------
----------------78417801010000017979797979010101797979797901010101010101010100000000000101010101010101010100000001010101010101010A017979797979010A0179797979790100000101784178----------------
----------------7841780101000001797979797901010179797979790101010101010101000000000001010101010101010101010A000000010101010101010A017979797979010A0179797979790100000101784178----------------
----------------7841780101000001797979797901010179797979790101010101010100000000000A01010101010101010101010A010000000101010101010A017979797979010A0179797979790100000101784178----------------
----------------7841780101000001797979797901010179797979790101010101010000000000010A01010101010101010101010A010100000001010101010A017979797979010A0179797979790100000101784178----------------
----------------7841780101000001010101010101010101010101010101010101000000000001010A01797979797979797979010A010101000000010101010A010101010101010A0101010101010100000101784178----------------
----------------7841780101000001787878010101017878780101010101010100000000000101010A01797979797979797979010A010101010000000A0A0A0A0A0A0A0A0A0A0A0A0A0A0A0A0A0A0A00000101784178----------------
--------------784141417878787878414141787878784141417801010101010000000000010101010A01797979797979797979010A010101010100000001010A010101010101010A0101010101010100000101784178----------------
--------------784141414141414141414141414141414141417801010101000000000001010101010A01797979797979797979010A01010101010A000000010A010101010101010A0179797979790100000101784178----------------
--------------784141417878787878414141787878784141414178010100000000000101010101010A01797979797979797979010A01010101010A010000000A010101010101010A0179797979790100000101784178----------------
----------------7841780101000001787878010101017878414141780000000000010101010101010A01010101010A01010101010A01010101010A0101000000010101010101010A0179797979790100000101784178----------------
----------------7841780101000001010101010101010101784141417800000001010101010101010A0A0A0A0A0A0A0A0A0A0A0A0A0A0A0A0A0A0A0A0A0A0000000101010101010A0179797979790100000101784178----------------
----------------7841780101000000000000000000000000007841414178000101010101010101010101010101010A01010101010101010101010A0101010100000001010101010A0179797979790A00000101784178----------------
----------------7841780101000000000000000000000000000078414141780101010101797979797979797979010A01797979797979797979010A0101010101000000010101010A0179797979790100000101784178----------------
----------------7841780101000000000000000000000000000000784141417801010101797979797979797979010A01797979797979797979010A0101010101010000000101010A0179797979790100000101784178----------------
----------------7841780101787801010179797901010178780000007841414178780101797979797979797979010A01797979797979797979010A0101010101010100000001010A0179797979790100000101784178----------------
----------------7841780178414178787878787878787841417800000078414141417801797979797979797979010A01797979797979797979010A0101010101010101000000010A0179797979790100000101784178----------------
----------------7841780178414141414141414141414141417800000001784141417801797979797979797979010A01797979797979797979010A0101010101010101010000000A0101010101010100000101784178----------------
----------------7841780101784141414141414141414141780100000001784141417801010101010A01010101010A01010101010A01010101010A010101010101010101010000000101010101010100000101784178----------------
----------------7841780101784141797979797979794141780100000001017841780101010101010A0A0A0A0A0A0A0A0A0A0A0A0A0A0A0A0A0A0A0A0A0A0A0A0A0A0A0A0A0A00000001010101010100000101784178----------------
----------------7841780101784141797979797979794141780100000001017841780101010101010101010101010A01010101010101010101010A010101010101010101010101000000010101010100000101784178----------------
----------------7841780101784141797979797979794141780100000001017841780101797979797979797979010A01797979797979797979010A017979797979797979790101010000000101010100000101784178----------------
----------------7841780101784141797979797979794141780100000001017841780101797979797979797979010A01797979797979797979010A017979797979797979790101010100000001010100000101784178----------------
----------------7841780101784141797979797979794141780100000001784141417801797979797979797979010A01797979797979797979010A017979797979797979790101010101000000010100000101784178----------------
----------------7841780101784141797979797979794141780100000001784141417801797979797979797979010A01797979797979797979010A017979797979797979790101010101010000000100000101784178----------------
----------------7841780101784141797979797979794141780100000001784141417801797979797979797979010A01797979797979797979010A017979797979797979790101010101010100000000000101784178----------------
----------------7841780101784141414141414141414141780100000001017841780101010101010A01010101010A01010101010A01010101010A01010101010A010101010101010101010101000000000101784178----------------
----------------78417801784141414141414141414141414178000000000078417800000000000000000000000000000000000000000000000000000000000000000000000000000000000000000000000101784178----------------
----------------78417801784141787878787878787878414178000000000078417800000000000000000000000000000000000000000000000000000000000000000000000000000000000000000000010101784178----------------
----------------78417801017878010101010101010101787801010101010178417801010101010101010101010101010101010101010101010101010101010101010101010101010101010101010101010101784178----------------
----------------78417801010101010101010101010101010101010101010178417801010101010101010101010101010101010101010101010101010101010101010101010101010101010101010101010101784178----------------
--------------784141417878787878787878787878787878787878787878784141417878787878787878787878787878787878787878787878787878787878787878787878787878787878787878787878787841414178--------------
--------------784141414141414141414141414141414141414141414141414141414141414141414141414141414141414141414141414141414141414141414141414141414141414141414141414141414141414178--------------
--------------784141417878787878787878787878787878787878787878784141417878787878787878787878787878787878787878787878787878787878787878787878787878787878787878787878787841414178--------------
----------------787878------------------------------------------787878--------------------------------------------------------------------------------------------------787878----------------
----------------------------------------------------------------------------------------------------------------------------------------------------------------------------------------------
----------------------------------------------------------------------------------------------------------------------------------------------------------------------------------------------
----------------------------------------------------------------------------------------------------------------------------------------------------------------------------------------------
----------------------------------------------------------------------------------------------------------------------------------------------------------------------------------------------
----------------------------------------------------------------------------------------------------------------------------------------------------------------------------------------------
----------------------------------------------------------------------------------------------------------------------------------------------------------------------------------------------
----------------------------------------------------------------------------------------------------------------------------------------------------------------------------------------------
