50,50,25,1,0
7878787878787878787878787878787878787878787878784141787878787878787878787878787878787878787878787878
7878787878787878787878787878787878787878787878780505787878787878787878787878787878787878787878787878
7878090909090909090909090909090909090909090909090909090909090909090909090909090909090909090909097878
7878090909090909090909090909090909090909090909090909090909090909090909090909090909090909090909097878
7878090978787878787878787878787878787878787878780909787878787878787878787878787878787878787809097878
7878090978090909090909090909090909090909090909780909780909090909090909090909090909090909097809097878
7878090978090909090909090909090909090909090909780909780909090909090909090909090909090909097809097878
7878090978090909090909090909090909090909090909780909780909090909090909090909090909090909097809097878
78780909780909093F3F3F3F3F3F3F3F3F3F3F3F090909090909090909093F3F3F3F3F3F3F3F3F3F3F3F0909097809097878
78780909780909093F3F3F3F3F3F3F3F3F3F3F3F090909090909090909093F3F3F3F3F3F3F3F3F3F3F3F0909097809097878
78780909780909093F3F0909090909090909090909090978090978090909090909090909090909093F3F0909097809097878
78780909780909093F3F0909090909090909090909090978090978090909090909090909090909093F3F0909097809097878
78780909780909093F3F0909090909090909090909090978090978090909090909090909090909093F3F0909097809097878
78780909780909093F3F0909097878787878787878787878090978787878787878787878780909093F3F0909097809097878
78780909780909093F3F09090978------------------78090978------------------780909093F3F0909097809097878
78780909780909093F3F09090978------------------78090978------------------780909093F3F0909097809097878
78780909780909093F3F09090978----787878787878787809097878787878787878----780909093F3F0909097809097878
78780909780909093F3F09090978----780909090909090909090909090909090978----780909093F3F0909097809097878
78780909780909093F3F09090978----780909090909090909090909090909090978----780909093F3F0909097809097878
78780909780909093F3F09090978----780909780505787878787878787878090978----780909093F3F0909097809097878
7878090978090909090909090978----780909784141824141414141414178090978----7809090909090909097809097878
7878090978090909090909090978----780909784141824141414141414178090978----7809090909090909097809097878
7878090978090909090909090978----780909784141824141828282414178090978----7809090909090909097809097878
7878090978787878090978787878787878090978414182414182--8241417809097878787878787809097878787809097878
7878090909090909090909090909090909090978414182414182--8241417809090909090909090909090909090909097878
7878090909090909090909090909090909090978414182414182--8241417809090909090909090909090909090909097878
7878090978787878090978787878787878090978414182--------8241417809097878787878787809097878787809097878
7878090978090909090909090978----780909784141828282828282414178090978----7809090909090909097809097878
7878090978090909090909090978----780909784141414141414141414178090978----7809090909090909097809097878
7878090978090909090909090978----780909784141414141414141414178090978----7809090909090909097809097878
78780909780909093F3F09090978----780909787878787878787878787878090978----780909093F3F0909097809097878
78780909780909093F3F09090978----780909090909090909090909090909090978----780909093F3F0909097809097878
78780909780909093F3F09090978----780909090909090909090909090909090978----780909093F3F0909097809097878
78780909780909093F3F09090978----787878787878787809097878787878787878----780909093F3F0909097809097878
78780909780909093F3F09090978------------------78090978------------------780909093F3F0909097809097878
78780909780909093F3F09090978------------------78090978------------------780909093F3F0909097809097878
78780909780909093F3F0909097878787878787878787878090978787878787878787878780909093F3F0909097809097878
78780909780909093F3F0909090909090909090909090978090978090909090909090909090909093F3F0909097809097878
78780909780909093F3F0909090909090909090909090978090978090909090909090909090909093F3F0909097809097878
78780909780909093F3F0909090909090909090909090978090978090909090909090909090909093F3F0909097809097878
78780909780909093F3F3F3F3F3F3F3F3F3F3F3F090909090909090909093F3F3F3F3F3F3F3F3F3F3F3F0909097809097878
78780909780909093F3F3F3F3F3F3F3F3F3F3F3F090909090909090909093F3F3F3F3F3F3F3F3F3F3F3F0909097809097878
7878090978090909090909090909090909090909090909780909780909090909090909090909090909090909097809097878
7878090978090909090909090909090909090909090909780909780909090909090909090909090909090909097809097878
7878090978090909090909090909090909090909090909780909780909090909090909090909090909090909097809097878
7878090978787878787878787878787878787878787878780909787878787878787878787878787878787878787809097878
7878090909090909090909090909090909090909090909090909090909090909090909090909090909090909090909097878
7878090909090909090909090909090909090909090909090909090909090909090909090909090909090909090909097878
7878787878787878787878787878787878787878787878787878787878787878787878787878787878787878787878787878
7878787878787878787878787878787878787878787878787878787878787878787878787878787878787878787878787878
