50,50,-1,-1,0
787878787878787878787878----------------------------------------------------787878787878787878787878
780505050505050505050578----------------------------------------------------780505050505050505050578
780505050505050505050578----------------------------------------------------780505050505050505050578
780505050505050505050578----------------------------------------------------780505050505050505050578
780505050505050505050578----------------------------------------------------780505050505050505050578
7805050505050505050505787878787878787878787878787878787878787878787878787878780505050505050505050578
7805050505050505050505050505050505050505050505050505050505050505050505050505050505050505050505050578
7805050505050505050505050505050505050505050505050505050505050505050505050505050505050505050505050578
7805050505050505050505050505050505050505050505050505050505050505050505050505050505050505050505050578
7805050505050505050505050505050505050505050505050505050505050505050505050505050505050505050505050578
7805050505050505050505050505050505050505050505050505050505050505050505050505050505050505050505050578
7878787878780505050505050505050505050505050505050505050505050505050505050505050505050505787878787878
----------78050505050505050505050505050505050505050505050505050505050505050505050505050578----------
----------78050505050505050505050505050505050505050505050505050505050505050505050505050578----------
----------78050505050505050505050505050505050505050505050505050505050505050505050505050578----------
----------78050505050505050505797979797979797979797979797979797979797905050505050505050578----------
----------78050505050505050505797979797979797979797979797979797979797905050505050505050578----------
----------78050505050505050505797979797979797979797979797979797979797905050505050505050578----------
----------78050505050505050505797979797979797979797979797979797979797905050505050505050578----------
----------78050505050505050505797979797979797979797979797979797979797905050505050505050578----------
----------78050505050505050505797979797979797979797979797979797979797905050505050505050578----------
----------78050505050505050505797979797979797979797979797979797979797905050505050505050578----------
----------78050505050505050505797979797979797979797979797979797979797905050505050505050578----------
----------78050505050505050505797979797979797979797979797979797979797905050505050505050578----------
----------78050505050505050505797979797979797979797979797979797979797905050505050505050578----------
----------78050505050505050505797979797979797979797979797979797979797905050505050505050578----------
----------78050505050505050505797979797979797979797979797979797979797905050505050505050578----------
----------78050505050505050505797979797979797979797979797979797979797905050505050505050578----------
----------78050505050505050505797979797979797979797979797979797979797905050505050505050578----------
----------78050505050505050505797979797979797979797979797979797979797905050505050505050578----------
----------78050505050505050505797979797979797979797979797979797979797905050505050505050578----------
----------78050505050505050505797979797979797979797979797979797979797905050505050505050578----------
----------78050505050505050505797979797979797979797979797979797979797905050505050505050578----------
----------78050505050505050505797979797979797979797979797979797979797905050505050505050578----------
----------78050505050505050505050505050505050509090909050505050505050505050505050505050578----------
----------78050505050505050505050505050505050509090909050505050505050505050505050505050578----------
----------78050505050505050505050505050505050505050505050505050505050505050505050505050578----------
----------78050505050505050505050505050505050505050505050505050505050505050505050505050578----------
7878787878780505050505050505050505050505050505050505050505050505050505050505050505050505787878787878
7805050505050505050505050505050505050505050505050505050505050505050505050505050505050505050505050578
7805050505050505050505050505050505050505050505050505050505050505050505050505050505050505050505050578
7805050505050505050505050505050505050505050505050505050505050505050505050505050505050505050505050578
7805050505050505050505050505050505050505050505050505050505050505050505050505050505050505050505050578
7805050505050505050505050505050505050505050505050505050505050505050505050505050505050505050505050578
7805050505050505050505787878787878787878787878787878787878787878787878787878780505050505050505050578
780505050505050505050578----------------------------------------------------780505050505050505050578
780505050505050505050578----------------------------------------------------780505050505050505050578
780505050505050505050578----------------------------------------------------780505050505050505050578
780505050505050505050578----------------------------------------------------780505050505050505050578
787878787878787878787878----------------------------------------------------787878787878787878787878
