50,50,10,0,1
19,21
23,26
-1,-1
-1,-1
-1,-1
-1,-1
-1,-1
-1,-1
-1,-1
-1,-1
B4B4B4B4B4B4B4B446B4B4B4B4B4B4B4B4B4B4B4B4B4B4B4B4B4B4B4B4B4B4B4B4B4B4B4B4B4B4B4B4B4B4B4B4B4B4B4B4B4
B4B4B4B4B4B4B4B44646B4B4B4B4B4B4B4B4B4B4B4B4B4B4B4B4B4B4B4B4B4B4B4B4B4B4B4B4B4B4B4B4B4B4B4B4B4B4B4B4
B4B4B4B4B4B4B4B4B446B4B4B4B4B4B4B4B4B4B4B4B4B4B4B4B4B4B4B4B4B4B4B4B4B4B4B4B4B4B4B4B4B4B4B4B4B4B4B4B4
B4B4B4B4B4B4B4B4B44646B4B4B4B4B4B4B4B4B4B4B4B4B4B4B4B4B4B4B4B4B4B4B4B4B4B4B4B4B4B4B4B4B4B4B4B4B4B4B4
B4B4B4B4B4B4B4B4B4B446B4B4B4B4B4B4B4B4B4B4B4B4B4B4B4B4B4B4B4B4B4B4B4B4B4B4B4B4B4B4B4B4B4B4B4B4B4B4B4
B4B4B4B4B4B4B4B4B4B446B4B4B4B4B4B4B4B4B4B4B4B4B4B4B4B4B4B4B4B4B4B4B4B4B4B4B4B4B4B4B4B4B4B4B4B4B4B4B4
B4B4B4B4B4B4B4B4B4B446B4B4B4B4B4B4B4B4B4B4B4B4B4B4B4B4B4B4B4B4B4B4B4B4B4B4B4B4B4B4B4B4B4B4B4B4B4B4B4
B4B4B4B4B4B4B4B4B4B446B4B4B4B4B4B4B4B4B4B4B4B4B4B4B4B4B4B4B4B4B4B4B4B4B4B4B4B4B4B4B4B4B4B4B4B4B4B4B4
46B4B4B4B4B4B4B4B44646B4B4B4B4B4B4B4B4B4B4B4B4B4B4B4B4B4B4B4B4B4B4B4B4B4B4B4B4B4B4B4B4B4B4B4B4B4B4B4
4646B4B4B4B4B4B4B446B4B4B4B4B4B4B4B4B4B4B4B4B4B4B4B4B4B4B4B4B4B4B4B4B4B4B4B4B4B4B4B4B4B4B4B4B4B4B4B4
B446B4B4B4B4B4B4B446B4B4B4B4B4B4B4B4B4B4B4B4B4B4B4B4B4B4B4B4B4B4B4B4B4B4B4B4B4B4B4B4B4B4B4B4B4B4B4B4
B4464646B4B4B4B4B446B4B4B4B4B4B4B4B4B4B4B4B4B4B4B4B4B4B4B4B4B4B4B4B4B4B4B4B4B4B4B4B4B4B4B4B4B4B4B4B4
B4B4B446464646B4B446B4B4B4B4B4B4B4B4B4B4B4B4B4B4B4B4B4B4B4B4B4B4B4B4B4B4B4B4B4B4B4B4B4B4B4B4B4B4B4B4
B4B4B4B4B4B446464646B4B4B4B4B4B4B4B4B4B4B4B4B4B4B4B4B4B4B4B4B4B4B4B4B4B4B4B4B4B4B4B4B4B4B4B4B4B4B4B4
B4B4B4B4B4B4B4B4B446B4B4B4B4B4B4B4B4B4B4B4B4B4B4B4B4B4B4B4B4B4B4B4B4B4B4B4B4B4B4B4B4B4B4B4B4B4B4B4B4
B4B4B4B4B4B4B4B4B44646B4B4B4B4B4B4B4B4B4B4B4B4B4B4B4B4B4B4B4B4B4B4B4B4B4B4B4B4B4B4B4B4B4B4B4B4B4B4B4
B4B4B4B4B4B4B4B4B4B446B4B4B4B4B4B4B4B4B4B4B4B4B4B4B4B4B4B4B4B4B4B4B4B4B4B4B4B4B4B4B4B4B4B4B4B4B4B4B4
B4B4B4B4B4B4B4B4B4B44646B4B4B4B4B4B4B4B4B4B4B4B4B4B4B4B4B4B4B4B4B4B4B4B4B4B4B4B4B4B4B4B4B4B4B4B4B4B4
B4B4B4B4B4B4B4B4B4B4B446B4B4B4B4B4B4B4B4B4B4B4B4B4B4B4B4B4B4B4B4B4B4B4B4B4B4B4B4B4B4B4B4B4B4B4B4B4B4
B4B4B4B4B4B4B4B4B4B4B44646B4B4B4B4B4B402B4B4B4B402B4B40202B4B4B4B4B4B4B4B4B4B4B4B4B4B4B4B4B4B4B4B4B4
B4B4B4B4B4B4B4B4B4B4B4B4464646B4B4B4B40202B4B40202B40202B4B4B4B4B4B4B4B4B4B4B4B4B4B4B4B4B4B4B4B4B4B4
B4B4B4B4B4B4B4B4B4B4B4B4B4B446464646460A0A0A02010202010102B4B4B4B4B4B4B4B4B4B4B4B4B4B4B4B4B4B4B4B4B4
B4B4B4B4B4B4B4B4B4B4B4B4B4B4B4B4B4B4B4B4020A0A01017979797902B4B4B4B4B4B4B4B4B4B4B4B4B4B4B4B4B4B4B4B4
B4B4B4B4B4B4B4B4B4B4B4B4B4B4B4B4B4B4B4B4B4020A0A0B79----79B4B4B4B4B4B4B4B4B4B4B4B4B4B4B4B4B4B4B4B4B4
B4B4B4B4B4B4B4B4B4B4B4B4B4B4B4B4B4B4B4B4B402010A0B79----79B4B4B4B4B4B4B4B4B4B4B4B4B4B4B4B4B4B4B4B4B4
B4B4B4B4B4B4B4B4B4B4B4B4B4B4B4B4B4B4B4B40202010A7979----790202B4B4B4B4B4B4B4B4B4B4B4B4B4B4B4B4B4B4B4
B4B4B4B4B4B4B4B4B4B4B4B4B4B4B4B4B4B4B4020201010A05------790202B4B4B4B4B4B4B4B4B4B4B4B4B4B4B4B4B4B4B4
B4B4B4B4B4B4B4B4B4B4B4B4B4B4B4B4B4B4B4B40201010A797979797902B4B4B4B4B4B4B4B4B4B4B4B4B4B4B4B4B4B4B4B4
B4B4B4B4B4B4B4B4B4B4B4B4B4B4B4B4B4B4B4B4B402020A010101010202B4B4B4B4B4B4B4B4B4B4B4B4B4B4B4B4B4B4B4B4
B4B4B4B4B4B4B4B4B4B4B4B4B4B4B4B4B4B4B4B4B402010A0101010101B4B4B4B4B4B4B4B4B4B4B4B4B4B4B4B4B4B4B4B4B4
B4B4B4B4B4B4B4B4B4B4B4B4B4B4B4B4B4B4B43E3EB4010A01010C0C01B43EB4B4B4B4B4B4B4B4B4B4B4B4B4B4B4B4B4B4B4
B4B4B4B4B4B4B4B4B4B4B4B4B4B4B4B4B4B43E3D484848464848484848483DB4B43E3EB4B4B4B4B4B4B4B43EB4B4B4B4B4B4
B4B4B4B4B4B4B4B4B4B4B4B4B4B4B43E3E3E48484848484648484848484848483D3D3E3E3EB4B4B4B4B43E3E3EB4B4B4B4B4
3EB4B4B4B4B4B4B4B4B4B4B43EB43D3D483D4848484848464848484848484848483D3D3E3E3EB43EB4B43E3EB4B4B4B4B4B4
3E3E3EB4B4B4B4B43E3EB43E3D4848483D48484848484846484848484848484848483D483D3E3E3EB4B4B43E3EB4B4B4B4B4
3D3D3E3EB43EB43E3D48B43D484848484848484848484848484848484848484848483D48483E483E3EB4B43E3E3E3E3EB4B4
3D3D3D3E48483D484848484848484848484848484848484848483F4848484848484848484848483D3D3E3E3E3D3D3D48483D
483D483D4848484848483F3F484848484848484848484848483F3F3F3F48483F4848484848484848483D483D3D3D3D484848
48484848484848484848483F48484848484848828282824848483F3F3F3F483F3F4848483F48484848484848483D48483F48
3F48484848483F48483F484848483F4848828282----824848483F3F3F3F483F3F48484848484848484848483D4848483F3F
3F3F483F483F3F3F3F3F3F48484848484882--------824848483F483F3F3F3F3F48483F3F483F48484848484848483F3F3F
3F3F3F3F3F3F3F3F3F3F3F3F3F483F3F4882828282828248484848483F3F3F3F3F3F483F3F3F3F48483F4848484848483F3F
3F3F3F3F3F3F3F3F3F3F3F3F3F3F3F3F48484848484848484848483F3F3F3F3F3F3F3F3F3F3F3F3F483F3F4848483F3F483F
3F3F3F3F3F3F3F3F3F3F3F3F3F3F3F3F3F3F483F484848484848483F3F3F3F3F3F3F3F3F3F3F3F3F3F3F3F3F3F3F3F3F3F3F
3F3F3F3F3F3F3F3F3F3F3F3F3F3F3F3F3F3F3F3F3F3F4848483F3F3F3F3F3F3F3F3F3F3F3F3F3F3F3F3F3F3F3F3F3F3F3F3F
3F3F3F3F3F3F3F3F3F3F3F3F3F3F3F3F3F3F3F3F3F3F3F3F3F3F3F3F3F3F3F3F3F3F3F3F3F3F3F3F3F3F3F3F3F3F3F3F3F3F
3F3F3F3F3F3F3F3F3F3F3F3F3F3F3F3F3F3F3F3F3F3F3F3F3F3F3F3F3F3F3F3F3F3F3F3F3F3F3F3F3F3F3F3F3F3F3F3F3F3F
3F3F3F3F3F3F3F3F3F3F3F3F3F3F3F3F3F3F3F3F3F3F3F3F3F3F3F3F3F3F3F3F3F3F3F3F3F3F3F3F3F3F3F3F3F3F3F3F3F3F
3F3F3F3F3F3F3F3F3F3F3F3F3F3F3F3F3F3F3F3F3F3F3F3F3F3F3F3F3F3F3F3F3F3F3F3F3F3F3F3F3F3F3F3F3F3F3F3F3F3F
3F3F3F3F3F3F3F3F3F3F3F3F3F3F3F3F3F3F3F3F3F3F3F3F3F3F3F3F3F3F3F3F3F3F3F3F3F3F3F3F3F3F3F3F3F3F3F3F3F3F
24,26,awesomeINT.map,1
