25,25,10,0,1
16,22
-1,-1
-1,-1
-1,-1
-1,-1
-1,-1
-1,-1
-1,-1
-1,-1
-1,-1
BFBFBFBFBFBFBFBFBFBFBFBFBFBFBFBFBFBFBFBFBFBFBFBFBF
BFBFBFBFBFBFBFBFBFBFBFBFBFBFBFBFBFBFBFBFBFBFBFBFBF
BFBFBFBFBFBFBFBFBFBFBFBFBFBFBFBFBFBFBFBFBFBFBFBFBF
BFBFBFBFBFBFBFBFBFBFBF7979797979797979797979797979
BFBFBFBFBFBFBFBFBFBFBF79------------------------79
BFBFBFBFBFBFBFBFBFBFBF79------------------------79
BFBFBFBFBFBFBFBFBFBFBF79------------------------79
BFBFBFBFBFBFBFBFBFBFBF79------------------------79
BFBFBF0E0E0E0E0E0E0E0E79------------------------79
BFBF0E0E0E0E0E0E0E0E0E79--------7979797979------79
BF0E0E0E0E0E0E0E0E0E0E79--------790E0E0E79------79
BFBF0E0E0E0E0E0E0E0E0E7979797979790E0E0E79------79
BFBEBE04040E0E0E0E0E0E0E0E0E0E0E0E0E0E0E79------79
BEBEBE0404040E0E0E0E0E0E0E0E0E0E0E0E0E0E7979797979
BEBE0404040E0E0E0E0EBFBF0E0E0E0E0E0E0E0E0E0E0E0E0E
BEBEBE0404040E0E0EBFBF0EBF0E0E0E0E0E0E0E0E0E0E0E0E
BE0404040E040E0E0EBFBFBF0E0E0E0E0E0E0E0E0E0E0E0E0E
BEBE04040E0E0E0E0E0EBFBFBFBF0E0E0E0E0EBFBF0E0E0E0E
BE040404040E0E0E0EBFBFBFBF0E0E0E0E0E0EBFBF0E0E0E0E
BEBE04040E0E0E0E0E0EBFBF0E0E0E0E0E0E0EBF0E0E0E0E0E
BEBEBE04040E0E0E0E0E0E0E0E0E0E0E0E0E0E0E0E0E0E0E0E
BEBE040404040E0E0E0E0E0E0E0E0E0E0E0E0E0E0E0E0E0E0E
BEBE040404040E0E0E0E0E0E0E0E0E0E0E0E0E0E0E0E0E0E0E
BEBEBE0404040E0E0E0E0E0E0E0E0E0E0E0E0E0E0E0E0E0E0E
BEBE0404040E0E0E0E0E0E0E0E0E0E0E0E0E0E0E0E0E0E0E0E
18,10,BPisland.map,3
