50,42,5,20,0
--------A26060A2--------A15F5FA1----------------------A46262A4--------------------------------------
--------A26060A2--------A15F5FA1----------------------A46262A4--------------------------------------
--------A26060A2--------A15F5FA1----------------------A46262A4--------------------------------------
--------A26060A2--------A15F5FA1----------------------A46262A4--------------------------------------
--------A26060A2--------A15F5FA1----------------------A46262A4--------------------------------------
--------A26060A2--------A15F5FA1----------------------A46262A4--------------------------------------
--------A26060A2--------A15F5FA1----------------------A46262A4--------------------------------------
--------A26060A2--------A15F5FA1----------------------A46262A4--------------------------------------
--------A26060A2--------A15F5FA1----------------------A46262A4--------------------------------------
--------A26060A2--------A15F5FA1------A4A4A4A4A4A4A4A4A46262A4--------------------------------------
--------A26060A2--------A15F5FA1------A462626262626262626262A4--------------------------------------
--------A26060A2--------A15F5FA1------A462626262626262626262A4--------------------------------------
--------A26060A2--------A15F5FA1------A46262A4A4A4A4A4A4A4A4A4--------------------------------------
--------A26060A2--------A15F5FA1------A46262A4------------------------------------------------------
--------A26060A2--------A15F5FA1------A46262A4------------------------------------------------------
--------A26060A2--------A15F5FA1------A46262A4------------------------------------------------------
--------A26060A2--------A15F5FA1------A46262A4------------------------------------------------------
--------A26060A2--------A15F5FA1------A46262A4------------------------------------------------------
--------A26060A2--------A15F5FA1------A46262A4------------------------------------------------------
--------A22424A2--------A15F5FA1------A46262A4------------------------------------------------------
--------A22424A2A2A2A2A2A26060A2A2A2A2A260608C8C8CA1A1A2A2A3A3A4A4A5A5A1A1A2A2A2A2A2A2A2A2A2A2A2A2A2
--------A22424242424242424242424242424242424070707232324246161626263635F5F60606060606060606060606060
--------A22424242424242424242424242424242424070707232324246161626263635F5F60606060606060606060606060
--------A2A2A2A2A2A26060A2A2A2A2A2A2A2A260608C8C8CA1A1A2A2A3A3A4A4A5A5A1A1A2A2A2A2A2A2A2A2A2A2A2A2A2
------------------A36161A3------------A56363A5------------------------------------------A56363A5----
------------------A36161A3------------A56363A5------------------------------------------A56363A5----
------------------A36161A3------------A56363A5------------------------------------------A56363A5----
------------------A36161A3------------A56363A5----------------------------------A5A5A5A5A56363A5A5A5
------------------A36161A3------------A56363A5----------------------------------A5636363636363636363
------------------A36161A3------------A56363A5----------------------------------A5636363636363636363
------------------A36161A3------------A56363A5----------------------------------A5636363636363636363
------------------A36161A3------------A56363A5----------------------------------A5636363636363636363
------------------A36161A3------------A56363A5----------------------------------A5636363636363636363
------------------A36161A3------------A56363A5----------------------------------A5636363636363636363
------------------A36161A3------------A56363A5A5A5A5A5A5A5A5A5A5A5A5A5A5A5A5A5A5A5636363636363636363
------------------A36161A3------------A5636363636363636363636363636363636363636363636363636363636363
------------------A36161A3------------A5636363636363636363636363636363636363636363636363636363636363
------------------A36161A3------------A5A5A5A5A5A5A5A5A5A5A56363A5A5A5A5A5A5A5A5A5636363636363636363
------------------A36161A3--------------------------------A56363A5--------------A5636363636363636363
------------------A36161A3--------------------------------A56363A5--------------A5636363636363636363
------------------A36161A3--------------------------------A56363A5--------------A5A5A5A5A5A5A5A5A5A5
------------------A36161A3--------------------------------A56363A5----------------------------------
