67,59,26,39,0
7A7A7A7A7A7A7A7A7A7A7A7A7A3E3D3D3D3D3D3D3D3D3D3D3D3D3D3D3D3D3D3D3D3D3D3D3E7A7A7A7A7A7A7A7A7A7A7A7A7A7A7A7A7A7A7A7A7A7A7A7A7A7A7A7A7A7A
7A7A7A7A7A7A7A7A7A7A7A7A7A7A3D3D3D3D3D3D3D3D3D3D3D3D3D3D3D3D3D3D3D3D3D3E3E7A7A7A7A7A7A7A7A7A7A7A7A7A7A7A7A7A7A7A7A7A7A7A7A7A7A7A7A7A7A
7A7A7A7A7A7A7A7A7A7A7A7A7A7A7A3D3D3D3D3D3D3D3D3D3D3D3D3D3D3D3D3D3D3D3D3D3E3E7A7A7A7A7A7A7A7A7A7A7A7A7A7A7A7A7A7A7A7A7A7A7A7A7A7A7A7A7A
7A7A7A7A7A7A7A7A7A7A7A7A3E3E3E3D3D3D3D3D3D3D3D3D3D3D3D3D3D3D3D3D3D3D3D3D3E7A3E7A7A7A7A7A7A7A7A7A7A7A7A7A7A7A7A7A7A7A7A7A7A7A7A7A7A7A7A
7A7A7A7A7A7A7A7A7A7A7A7A7A3E3D3D3D3D3D3D3D3D3D3D3D3D3D3D3D3D3D3D3D3D3D3D3D3E3E7A7A7A7A7A7A7A7A7A7A7A7A7A7A7A7A7A7A7A7A7A7A7A7A7A7A7A7A
7A7A7A7A7A7A7A7A7A7A7A7A7A7A3E3D3C3C3C3C3C3C3C3C79797979797979797979797979797979797A7A7A7A7A7A7A7A7A7A7A7A7A7A7A7A7A7A7A7A7A7A7A7A7A7A
7A7A7A7A7A7A7A7A7A7A7A7A7A3E7A3D3C3F3F3F3F3F3C3C79------------------------------797A7A7A7A7A7A7A7A7A7A7A7A7A7A7A7A7A7A7A7A7A7A7A7A7A7A
7A7A7A7A7A7A7A7A7A7A7A7A7A3E3D3D3C3F3F3F3F3F3C3C79------------------------------797A7A7A7A7A7A7A7A7A7A7A7A7A7A7A7A7A7A7A7A7A7A7A7A7A7A
7A7A7A7A7A7A7A7A7A7A7A7A7A7A3E3D3C3F3F3F3F3F3C3C79------------------------------797A7A7A7A7A7A7A7A7A7A7A7A7A7A7A7A7A7A7A7A7A7A7A7A7A7A
7A7A7A7A7A7A7A7A7A7A7A7A7A7A7A3D3C3C3C3C3C3C3C3C79------------------------------797A7A7A7A7A7A7A7A7A7A7A7A7A7A7A7A7A7A7A7A7A7A7A7A7A7A
7A7A7A7A7A7A7A7A7A7A7A7A7A3E3E3D797979797979797979------------------------------797A7A7A7A7A7A7A7A7A7A7A7A7A7A7A7A7A7A7A7A7A7A7A7A7A7A
7A7A7A7A7A7A7A7A7A7A7A7A7A7A3E3D79----------------------------------------------793E3E7A7A7A7A7A7A7A7A7A7A7A7A7A7A7A7A7A7A7A7A7A7A7A7A
7A7A7A7A7A7A7A7A7A7A7A7A7A7A7A3E79----------------------------------------------793E3E3E3E7A3E7A7A7A7A7A7A7A7A7A7A7A7A7A7A7A7A7A7A7A7A
7A7A7A7A7A7A7A7A7A7A7A7A7A7A7A3E79----------------------------------------------793E7A3E3E3E3E7A7A7A7A7A7A7A7A7A7A7A7A7A7A7A7A7A7A7A7A
7A7A7A7A7A7A7A7A7A7A7A7A7A7A7A3E79----------------------------------------------797A7A7A3E3E7A7A7A7A7A7A7A7A7A7A7A7A7A7A7A7A7A7A7A7A7A
7A7A7A7A7A7A7A7A7A7A7A7A7A7A7A7A79----------------------------------------------797A7A7A7A3E3E7A7A7A7A7A7A7A7A7A7A7A7A7A7A7A7A7A7A7A7A
7A7A7A7A7A7A7A7A7A7A7A7A7A7A7A7A79----------------------------------------------797A7A7A7A7A7A7A7A7A7A7A7A7A7A7A7A7A7A7A7A7A7A7A7A7A7A
7A7A7A7A7A7A7A7A7A7A7A7A7A7A7A7A79----------------------------------------------797A7A7A7A7A7A7A7A7A7A7A7A7A7A7A7A7A7A7A7A7A7A7A7A7A7A
7A7A7A7A7A7A7A7A7A7A7A7A7A7A7A7A79----------------------------------------------797A7A7A7A7A7A7A7A7A7A7A7A7A7A7A7A7A7A7A7A7A7A7A7A7A7A
7A7A7A7A7A7A7A7A7A7A7A7A7A7A7A7A79----------------------------------------------79027A7A7A7A7A7A7A7A7A7A7A3E7A7A7A7A7A7A7A7A7A7A7A7A7A
7A7A7A7A7A7A7A7A7A7A7A7A7A7A7A7A79797979797979797979797979797979797979797979797979027A7A02027A7A7A7A7A7A7A3E7A7A7A7A7A7A7A7A7A7A7A7A7A
7A7A7A7A7A7A7A7A7A7A7A7A7A7A7A7A7A7A7A7A02020202010A017A7A0202027A7A7A7A02020101010202020102027A7A7A7A7A3E3E7A7A7A7A7A7A7A7A7A7A7A7A7A
7A7A7A7A7A7A7A7A7A7A7A7A7A7A7A7A7A7A7A7A7A7A0201010A01027A02027A7A7A7A7A027A020101010102010102027A7A7A3E3E3E7A7A7A7A7A7A7A7A7A7A7A7A7A
7A7A7A7A7A7A7A7A7A7A7A7A7A7A7A7A7A7A7A7A7A020201010A010102027A7A7A7A7A7A7A020201010102010101027A7A7A7A3E3E3E3E7A7A7A7A7A7A7A7A7A7A7A7A
7A7A7A7A7A7A7A7A7A7A7A7A7A7A7A7A7A7A7A7A02020202010A010101017A7A7A7A7A7A020202010202020201027A7A7A7A7A7A3E3E7A7A7A7A7A7A7A7A7A7A7A7A7A
7A7A7A7A7A7A7A7A7A7A7A7A7A7A7A7A7A7A7A7A7A020201010A0101010101027A7A7A7A7A020202027A7A0202027A7A7A7A3E3E3E3E3E7A7A7A7A7A7A7A7A7A7A7A7A
7A7A7A7A7A7A7A7A7A7A7A7A7A7A7A7A7A7A7A0202020101010A0101010101027A7A7A7A7A7A0202027A7A0202027A7A7A7A3E3E3E3E3E7A7A7A7A7A7A7A7A7A7A7A7A
7A7A7A7A7A7A7A7A7A7A7A7A7A7A7A7A7A7A7A7A02020102010A0A010101027A02027A7A7A7A027A7A7A0202020202027A7A7A3E3E3E3E3E3E7A7A7A7A7A7A7A7A7A7A
7A7A7A7A7A7A7A7A7A7A7A7A7A7A7A7A7A7A7A7A7A02020201010A01010102020202027A7A7A7A7A7A0202020202027A3E7A7A7A3E3E3E3E7A7A7A7A7A7A7A7A7A7A7A
7A7A7A7A7A7A7A7A7A7A7A7A7A7A7A7A7A7A7A7A7A7A020201010A01010101020202027A7A7A7A7A02020202027A7A7A7A7A7A7A3E3E3E3E7A7A7A7A7A7A7A7A7A7A7A
7A7A7A7A7A7A7A7A7A7A7A7A7A7A7A7A7A7A7A7A7A7A020102010A01010101027A7A027A7A7A7A7A0202020202027A7A7A7A7A3E3E3E3E7A7A7A7A7A7A7A7A7A7A7A7A
7A7A7A7A7A7A7A7A7A7A7A7A7A7A7A7A7A7A7A7A0202020101010A01010101017A7A7A7A7A7A020202020202027A7A7A7A7A3E3E7A3E7A7A7A7A7A7A7A7A7A7A7A7A7A
7A7A7A7A7A7A7A7A7A7A7A7A7A7A7A7A7A7A7A020202020101010A017A7A0101017A7A7A7A7A0202020202027A7A7A3E3E3E3E7A7A7A7A7A7A7A7A7A7A7A7A7A7A7A7A
7A7A7A7A7A7A7A7A7A7A7A7A7A7A7A7A7A7A7A020201010101010A017A7A7A01017A7A027A02020202020202027A7A7A3E3E3E7A7A7A7A7A7A7A7A7A7A7A7A7A7A7A7A
7A7A7A7A7A7A7A7A7A7A7A7A7A7A7A7A7A7A7A020101010101010A01017A7A01010101010202027A0202020202027A7A3E7A7A7A7A7A7A7A7A7A7A7A7A7A7A7A7A7A7A
7A7A7A7A7A7A7A7A7A7A7A7A7A7A7A7A7A7A7A7A0202010101010A0A0A0A0A0A0A0A0A0101027A7A0202027A7A027A7A3E3E7A7A7A7A7A7A7A7A7A7A7A7A7A7A7A7A7A
7A7A7A7A7A7A7A7A7A7A7A7A7A7A7A7A7A7A7A7A0201010101010A0A010101010101010102027A7A02027A7A7A7A7A7A3E3E7A7A7A7A7A7A7A7A7A7A7A7A7A7A7A7A7A
7A7A7A7A7A7A7A7A7A7A7A7A7A7A7A7A7A7A7A7A7A02020201010A010101010101020102027A3E7A7A027A7A3E7A7A3E7A3E3E7A7A7A7A7A7A7A7A7A7A7A7A7A7A7A7A
7A7A7A7A7A7A7A7A7A7A7A7A7A7A7A7A7A7A7A7A0202020101010A0101010101020202027A7A7A7A7A7A3E3E3E3E7A7A7A7A3E7A7A7A7A7A7A7A7A7A7A7A7A7A7A7A7A
7A7A7A7A7A7A7A7A7A7A7A7A7A7A7A7A7A7A7A7A027A020201010A010101027A01027A7A7A7A7A3E7A7A3E3E7A3E7A7A7A7A7A7A7A7A7A7A7A7A7A7A7A7A7A7A7A7A7A
7A7A7A7A7A7A7A7A7A7A7A7A7A7A7A7A7A7A7A7A7A7A3E7A7A3D463D7A7A7A7A7A7A3E3E3E7A3E3E3E3E3E7A7A7A7A7A7A7A7A7A7A7A7A7A7A7A7A7A7A7A7A7A7A7A7A
7A7A7A7A7A7A7A7A7A7A7A7A7A7A7A7A7A7A7A7A7A7A3E7A7A3D463D3D7A3E3E3E7A3E7A7A7A3E3E3E3E3E7A7A7A7A7A7A7A7A7A7A7A7A7A7A7A7A7A7A7A7A7A7A7A7A
7A7A7A7A7A7A7A7A7A7A7A7A7A7A7A7A7A7A7A7A7A3E3E3E3D3D463D3D3D3E3E3E3E7A7A7A7A7A7A3E3E3E3E7A7A7A7A7A7A7A7A7A7A7A7A7A7A7A7A7A3E7A7A7A7A3E
7A7A7A7A7A7A7A7A7A7A7A7A7A7A7A7A7A7A7A7A7A3E3E3E3D3D463D7A7A3D3E3E3E7A7A7A7A7A7A7A7A7A3E7A7A7A7A7A7A7A7A7A7A7A7A7A7A7A7A7A3E3E7A3E3E3E
7A7A7A7A7A7A7A7A7A7A7A7A7A7A7A7A7A7A7A7A7A7A3E3D3D46463D7A7A7A3E3E3E7A7A7A7A7A7A7A7A7A7A7A7A7A7A7A7A7A7A7A7A7A7A7A7A7A7A7A7A3E3E7A3E3E
7A7A7A7A7A7A7A7A7A7A7A7A7A7A7A7A7A7A7A7A7A3E3E3D3D463D3D3D7A7A3E3E3E3E7A7A7A7A7A7A7A7A7A7A7A7A7A7A7A7A7A7A7A7A7A7A7A7A7A3E3E3E3E3E3E3D
7A7A7A7A7A7A7A7A7A7A7A7A7A7A7A7A7A7A7A7A7A3E3E3E3D463D3D3D3D3D3D3E3E3E7A7A7A7A7A7A7A7A7A7A7A7A7A7A7A7A7A7A7A7A7A7A7A3E3E3E3D3E3D3E3D7A
7A7A7A7A7A7A7A7A7A3E3E7A7A7A7A7A7A7A7A3E7A3E3D3D3D463D3D3D3D3E3E3E3E7A7A7A7A7A7A7A7A7A7A7A7A7A7A7A7A7A7A7A7A7A7A7A7A3E3E3E3D3D3D3D3D7A
7A7A7A7A7A7A7A7A7A3E3E3E7A7A7A7A7A7A7A7A3E3E3E3D3D463D7A3D3D3D3E3E3E7A7A7A7A7A7A7A7A7A7A7A7A7A7A7A7A7A7A7A7A7A7A7A3E3E3D3D3D3D3D3D3D3D
7A7A7A7A7A7A7A7A3E3E3E3E7A3E7A7A7A7A7A7A3E3E3D3D3D463D7A7A3D3E3E3E3E3E7A7A7A7A7A7A7A7A7A7A7A7A7A7A7A7A7A7A7A7A7A7A7A3E3E3E3D3D3D3D3D3D
7A7A7A7A7A7A7A3E7A3E3E3E3E3E7A7A7A7A7A7A3E7A3E3D3D463D3D3D3D3D3E3E7A7A7A7A7A7A7A7A7A7A7A7A7A7A7A7A7A7A7A7A7A7A3E7A7A3E3E3E3D3D7A7A3D3D
7A7A7A7A7A7A7A7A7A3E3E3E3E3E3E7A7A7A7A7A7A7A7A3D3D463D3D3D3D3D3E3E7A7A7A7A7A7A7A7A7A7A7A3E7A7A7A7A7A7A7A7A7A7A7A3E3E3E3E3D3D3D7A7A7A3D
7A7A7A7A7A7A7A7A7A7A3E3E3E3E7A7A7A7A7A7A7A3E7A7A3D463D3D3D3E3D3E3E7A7A7A7A7A7A7A7A7A3E3E3E7A7A7A7A7A7A7A7A7A7A7A7A3E7A7A3E3D3D3D7A7A3D
7A7A7A7A7A7A7A7A7A7A3E7A3E7A7A7A7A7A7A7A7A7A7A3D3D46463D3D3D3E3E7A7A7A7A7A7A7A7A7A7A7A3E3E3E7A7A7A7A7A7A7A7A7A7A7A7A7A7A3D3E3D3D3D3D3D
7A7A7A7A7A7A7A7A7A7A7A7A7A7A7A7A7A7A7A7A7A7A7A7A3E3D463D3D3D3E3E3E7A7A7A7A7A7A7A7A7A7A3E3E7A7A7A7A7A7A7A7A7A7A7A7A3E3E3E3E3E3D3D3D3D3D
7A7A7A7A7A7A7A7A7A7A7A7A7A7A7A7A7A7A7A7A7A7A7A7A7A3E463D3E3D3E3E7A7A7A7A7A7A7A7A7A7A7A7A7A7A7A7A7A7A7A7A7A7A7A7A7A7A3E7A3E3E3E3E3D3D3D
7A7A7A7A7A7A7A7A7A7A7A7A7A7A7A7A7A7A7A7A7A7A7A7A3E3E463E3E3E3E7A7A7A7A7A7A7A7A7A7A7A7A7A7A7A7A7A7A7A7A7A7A7A7A7A7A7A7A7A3E3E3E3D7A7A3D
7A7A7A7A7A7A7A7A7A7A7A7A7A7A7A7A7A7A7A7A7A7A7A7A7A3E463E3E7A3E3E7A7A7A7A7A7A7A7A7A7A7A7A7A7A7A7A7A7A7A7A7A7A7A7A7A7A7A7A7A7A3E7A7A7A3D
7A7A7A7A7A7A7A7A7A7A7A7A7A7A7A7A7A7A7A7A7A7A7A3E3E3E463E7A7A7A3E7A3E7A7A7A7A7A7A7A7A7A7A7A7A7A7A7A7A7A7A7A7A7A7A7A7A7A7A7A7A7A3E3E3D3D
