67,59,1,0,0
26,39
B4B4B4B4B4B4B4B4B4B4B4B4B43E3D3D3D3D3D3D3D3D3D3D3D3D3D3D3D3D3D3D3D3D3D3D3EB4B4B4B4B4B4B4B4B4B4B4B4B4B4B4B4B4B4B4B4B4B4B4B4B4B4B4B4B4B4
B4B4B4B4B4B4B4B4B4B4B4B4B4B43D3D3D3D3D3D3D3D3D3D3D3D3D3D3D3D3D3D3D3D3D3E3EB4B4B4B4B4B4B4B4B4B4B4B4B4B4B4B4B4B4B4B4B4B4B4B4B4B4B4B4B4B4
B4B4B4B4B4B4B4B4B4B4B4B4B4B4B43D3D3D3D3D3D3D3D3D3D3D3D3D3D3D3D3D3D3D3D3D3E3EB4B4B4B4B4B4B4B4B4B4B4B4B4B4B4B4B4B4B4B4B4B4B4B4B4B4B4B4B4
B4B4B4B4B4B4B4B4B4B4B4B43E3E3E3D3D3D3D3D3D3D3D3D3D3D3D3D3D3D3D3D3D3D3D3D3EB43EB4B4B4B4B4B4B4B4B4B4B4B4B4B4B4B4B4B4B4B4B4B4B4B4B4B4B4B4
B4B4B4B4B4B4B4B4B4B4B4B4B43E3D3D3D3D3D3D3D3D3D3D3D3D3D3D3D3D3D3D3D3D3D3D3D3E3EB4B4B4B4B4B4B4B4B4B4B4B4B4B4B4B4B4B4B4B4B4B4B4B4B4B4B4B4
B4B4B4B4B4B4B4B4B4B4B4B4B4B43E3D3C3C3C3C3C3C3C3C7979797979797979797979797979797979B4B4B4B4B4B4B4B4B4B4B4B4B4B4B4B4B4B4B4B4B4B4B4B4B4B4
B4B4B4B4B4B4B4B4B4B4B4B4B43EB43D3C3F3F3F3F3F3C3C79------------------------------79B4B4B4B4B4B4B4B4B4B4B4B4B4B4B4B4B4B4B4B4B4B4B4B4B4B4
B4B4B4B4B4B4B4B4B4B4B4B4B43E3D3D3C3F3F3F3F3F3C3C79------------------------------79B4B4B4B4B4B4B4B4B4B4B4B4B4B4B4B4B4B4B4B4B4B4B4B4B4B4
B4B4B4B4B4B4B4B4B4B4B4B4B4B43E3D3C3F3F3F3F3F3C3C79------------------------------79B4B4B4B4B4B4B4B4B4B4B4B4B4B4B4B4B4B4B4B4B4B4B4B4B4B4
B4B4B4B4B4B4B4B4B4B4B4B4B4B4B43D3C3C3C3C3C3C3C3C79------------------------------79B4B4B4B4B4B4B4B4B4B4B4B4B4B4B4B4B4B4B4B4B4B4B4B4B4B4
B4B4B4B4B4B4B4B4B4B4B4B4B43E3E3D797979797979797979------------------------------79B4B4B4B4B4B4B4B4B4B4B4B4B4B4B4B4B4B4B4B4B4B4B4B4B4B4
B4B4B4B4B4B4B4B4B4B4B4B4B4B43E3D79----------------------------------------------793E3EB4B4B4B4B4B4B4B4B4B4B4B4B4B4B4B4B4B4B4B4B4B4B4B4
B4B4B4B4B4B4B4B4B4B4B4B4B4B4B43E79----------------------------------------------793E3E3E3EB43EB4B4B4B4B4B4B4B4B4B4B4B4B4B4B4B4B4B4B4B4
B4B4B4B4B4B4B4B4B4B4B4B4B4B4B43E79----------------------------------------------793EB43E3E3E3EB4B4B4B4B4B4B4B4B4B4B4B4B4B4B4B4B4B4B4B4
B4B4B4B4B4B4B4B4B4B4B4B4B4B4B43E79----------------------------------------------79B4B4B43E3EB4B4B4B4B4B4B4B4B4B4B4B4B4B4B4B4B4B4B4B4B4
B4B4B4B4B4B4B4B4B4B4B4B4B4B4B4B479----------------------------------------------79B4B4B4B43E3EB4B4B4B4B4B4B4B4B4B4B4B4B4B4B4B4B4B4B4B4
B4B4B4B4B4B4B4B4B4B4B4B4B4B4B4B479----------------------------------------------79B4B4B4B4B4B4B4B4B4B4B4B4B4B4B4B4B4B4B4B4B4B4B4B4B4B4
B4B4B4B4B4B4B4B4B4B4B4B4B4B4B4B479----------------------------------------------79B4B4B4B4B4B4B4B4B4B4B4B4B4B4B4B4B4B4B4B4B4B4B4B4B4B4
B4B4B4B4B4B4B4B4B4B4B4B4B4B4B4B479----------------------------------------------79B4B4B4B4B4B4B4B4B4B4B4B4B4B4B4B4B4B4B4B4B4B4B4B4B4B4
B4B4B4B4B4B4B4B4B4B4B4B4B4B4B4B479----------------------------------------------7902B4B4B4B4B4B4B4B4B4B4B43EB4B4B4B4B4B4B4B4B4B4B4B4B4
B4B4B4B4B4B4B4B4B4B4B4B4B4B4B4B47979797979797979797979797979797979797979797979797902B4B40202B4B4B4B4B4B4B43EB4B4B4B4B4B4B4B4B4B4B4B4B4
B4B4B4B4B4B4B4B4B4B4B4B4B4B4B4B4B4B4B4B402020202010A01B4B4020202B4B4B4B40202010101020202010202B4B4B4B4B43E3EB4B4B4B4B4B4B4B4B4B4B4B4B4
B4B4B4B4B4B4B4B4B4B4B4B4B4B4B4B4B4B4B4B4B4B40201010A0102B40202B4B4B4B4B402B402010101010201010202B4B4B43E3E3EB4B4B4B4B4B4B4B4B4B4B4B4B4
B4B4B4B4B4B4B4B4B4B4B4B4B4B4B4B4B4B4B4B4B4020201010A01010202B4B4B4B4B4B4B402020101010201010102B4B4B4B43E3E3E3EB4B4B4B4B4B4B4B4B4B4B4B4
B4B4B4B4B4B4B4B4B4B4B4B4B4B4B4B4B4B4B4B402020202010A01010101B4B4B4B4B4B402020201020202020102B4B4B4B4B4B43E3EB4B4B4B4B4B4B4B4B4B4B4B4B4
B4B4B4B4B4B4B4B4B4B4B4B4B4B4B4B4B4B4B4B4B4020201010A010101010102B4B4B4B4B402020202B4B4020202B4B4B4B43E3E3E3E3EB4B4B4B4B4B4B4B4B4B4B4B4
B4B4B4B4B4B4B4B4B4B4B4B4B4B4B4B4B4B4B40202020101010A010101010102B4B4B4B4B4B4020202B4B4020202B4B4B4B43E3E3E3E3EB4B4B4B4B4B4B4B4B4B4B4B4
B4B4B4B4B4B4B4B4B4B4B4B4B4B4B4B4B4B4B4B402020102010A0A01010102B40202B4B4B4B402B4B4B4020202020202B4B4B43E3E3E3E3E3EB4B4B4B4B4B4B4B4B4B4
B4B4B4B4B4B4B4B4B4B4B4B4B4B4B4B4B4B4B4B4B402020201010A0101010202020202B4B4B4B4B4B4020202020202B43EB4B4B43E3E3E3EB4B4B4B4B4B4B4B4B4B4B4
B4B4B4B4B4B4B4B4B4B4B4B4B4B4B4B4B4B4B4B4B4B4020201010A0101010102020202B4B4B4B4B40202020202B4B4B4B4B4B4B43E3E3E3EB4B4B4B4B4B4B4B4B4B4B4
B4B4B4B4B4B4B4B4B4B4B4B4B4B4B4B4B4B4B4B4B4B4020102010A0101010102B4B402B4B4B4B4B4020202020202B4B4B4B4B43E3E3E3EB4B4B4B4B4B4B4B4B4B4B4B4
B4B4B4B4B4B4B4B4B4B4B4B4B4B4B4B4B4B4B4B40202020101010A0101010101B4B4B4B4B4B402020202020202B4B4B4B4B43E3EB43EB4B4B4B4B4B4B4B4B4B4B4B4B4
B4B4B4B4B4B4B4B4B4B4B4B4B4B4B4B4B4B4B4020202020101010A01B4B4010101B4B4B4B4B4020202020202B4B4B43E3E3E3EB4B4B4B4B4B4B4B4B4B4B4B4B4B4B4B4
B4B4B4B4B4B4B4B4B4B4B4B4B4B4B4B4B4B4B4020201010101010A01B4B4B40101B4B402B40202020202020202B4B4B43E3E3EB4B4B4B4B4B4B4B4B4B4B4B4B4B4B4B4
B4B4B4B4B4B4B4B4B4B4B4B4B4B4B4B4B4B4B4020101010101010A0101B4B40101010101020202B4020202020202B4B43EB4B4B4B4B4B4B4B4B4B4B4B4B4B4B4B4B4B4
B4B4B4B4B4B4B4B4B4B4B4B4B4B4B4B4B4B4B4B40202010101010A0A0A0A0A0A0A0A0A010102B4B4020202B4B402B4B43E3EB4B4B4B4B4B4B4B4B4B4B4B4B4B4B4B4B4
B4B4B4B4B4B4B4B4B4B4B4B4B4B4B4B4B4B4B4B40201010101010A0A01010101010101010202B4B40202B4B4B4B4B4B43E3EB4B4B4B4B4B4B4B4B4B4B4B4B4B4B4B4B4
B4B4B4B4B4B4B4B4B4B4B4B4B4B4B4B4B4B4B4B4B402020201010A01010101010102010202B43EB4B402B4B43EB4B43EB43E3EB4B4B4B4B4B4B4B4B4B4B4B4B4B4B4B4
B4B4B4B4B4B4B4B4B4B4B4B4B4B4B4B4B4B4B4B40202020101010A010101010102020202B4B4B4B4B4B43E3E3E3EB4B4B4B43EB4B4B4B4B4B4B4B4B4B4B4B4B4B4B4B4
B4B4B4B4B4B4B4B4B4B4B4B4B4B4B4B4B4B4B4B402B4020201010A01010102B40102B4B4B4B4B43EB4B43E3EB43EB4B4B4B4B4B4B4B4B4B4B4B4B4B4B4B4B4B4B4B4B4
B4B4B4B4B4B4B4B4B4B4B4B4B4B4B4B4B4B4B4B4B4B43EB4B43D463DB4B4B4B4B4B43E3E3EB43E3E3E3E3EB4B4B4B4B4B4B4B4B4B4B4B4B4B4B4B4B4B4B4B4B4B4B4B4
B4B4B4B4B4B4B4B4B4B4B4B4B4B4B4B4B4B4B4B4B4B43EB4B43D463D3DB43E3E3EB43EB4B4B43E3E3E3E3EB4B4B4B4B4B4B4B4B4B4B4B4B4B4B4B4B4B4B4B4B4B4B4B4
B4B4B4B4B4B4B4B4B4B4B4B4B4B4B4B4B4B4B4B4B43E3E3E3D3D463D3D3D3E3E3E3EB4B4B4B4B4B43E3E3E3EB4B4B4B4B4B4B4B4B4B4B4B4B4B4B4B4B43EB4B4B4B43E
B4B4B4B4B4B4B4B4B4B4B4B4B4B4B4B4B4B4B4B4B43E3E3E3D3D463DB4B43D3E3E3EB4B4B4B4B4B4B4B4B43EB4B4B4B4B4B4B4B4B4B4B4B4B4B4B4B4B43E3EB43E3E3E
B4B4B4B4B4B4B4B4B4B4B4B4B4B4B4B4B4B4B4B4B4B43E3D3D46463DB4B4B43E3E3EB4B4B4B4B4B4B4B4B4B4B4B4B4B4B4B4B4B4B4B4B4B4B4B4B4B4B4B43E3EB43E3E
B4B4B4B4B4B4B4B4B4B4B4B4B4B4B4B4B4B4B4B4B43E3E3D3D463D3D3DB4B43E3E3E3EB4B4B4B4B4B4B4B4B4B4B4B4B4B4B4B4B4B4B4B4B4B4B4B4B43E3E3E3E3E3E3D
B4B4B4B4B4B4B4B4B4B4B4B4B4B4B4B4B4B4B4B4B43E3E3E3D463D3D3D3D3D3D3E3E3EB4B4B4B4B4B4B4B4B4B4B4B4B4B4B4B4B4B4B4B4B4B4B43E3E3E3D3E3D3E3DB4
B4B4B4B4B4B4B4B4B43E3EB4B4B4B4B4B4B4B43EB43E3D3D3D463D3D3D3D3E3E3E3EB4B4B4B4B4B4B4B4B4B4B4B4B4B4B4B4B4B4B4B4B4B4B4B43E3E3E3D3D3D3D3DB4
B4B4B4B4B4B4B4B4B43E3E3EB4B4B4B4B4B4B4B43E3E3E3D3D463DB43D3D3D3E3E3EB4B4B4B4B4B4B4B4B4B4B4B4B4B4B4B4B4B4B4B4B4B4B43E3E3D3D3D3D3D3D3D3D
B4B4B4B4B4B4B4B43E3E3E3EB43EB4B4B4B4B4B43E3E3D3D3D463DB4B43D3E3E3E3E3EB4B4B4B4B4B4B4B4B4B4B4B4B4B4B4B4B4B4B4B4B4B4B43E3E3E3D3D3D3D3D3D
B4B4B4B4B4B4B43EB43E3E3E3E3EB4B4B4B4B4B43EB43E3D3D463D3D3D3D3D3E3EB4B4B4B4B4B4B4B4B4B4B4B4B4B4B4B4B4B4B4B4B4B43EB4B43E3E3E3D3DB4B43D3D
B4B4B4B4B4B4B4B4B43E3E3E3E3E3EB4B4B4B4B4B4B4B43D3D463D3D3D3D3D3E3EB4B4B4B4B4B4B4B4B4B4B43EB4B4B4B4B4B4B4B4B4B4B43E3E3E3E3D3D3DB4B4B43D
B4B4B4B4B4B4B4B4B4B43E3E3E3EB4B4B4B4B4B4B43EB4B43D463D3D3D3E3D3E3EB4B4B4B4B4B4B4B4B43E3E3EB4B4B4B4B4B4B4B4B4B4B4B43EB4B43E3D3D3DB4B43D
B4B4B4B4B4B4B4B4B4B43EB43EB4B4B4B4B4B4B4B4B4B43D3D46463D3D3D3E3EB4B4B4B4B4B4B4B4B4B4B43E3E3EB4B4B4B4B4B4B4B4B4B4B4B4B4B43D3E3D3D3D3D3D
B4B4B4B4B4B4B4B4B4B4B4B4B4B4B4B4B4B4B4B4B4B4B4B43E3D463D3D3D3E3E3EB4B4B4B4B4B4B4B4B4B43E3EB4B4B4B4B4B4B4B4B4B4B4B43E3E3E3E3E3D3D3D3D3D
B4B4B4B4B4B4B4B4B4B4B4B4B4B4B4B4B4B4B4B4B4B4B4B4B43E463D3E3D3E3EB4B4B4B4B4B4B4B4B4B4B4B4B4B4B4B4B4B4B4B4B4B4B4B4B4B43EB43E3E3E3E3D3D3D
B4B4B4B4B4B4B4B4B4B4B4B4B4B4B4B4B4B4B4B4B4B4B4B43E3E463E3E3E3EB4B4B4B4B4B4B4B4B4B4B4B4B4B4B4B4B4B4B4B4B4B4B4B4B4B4B4B4B43E3E3E3DB4B43D
B4B4B4B4B4B4B4B4B4B4B4B4B4B4B4B4B4B4B4B4B4B4B4B4B43E463E3EB43E3EB4B4B4B4B4B4B4B4B4B4B4B4B4B4B4B4B4B4B4B4B4B4B4B4B4B4B4B4B4B43EB4B4B43D
B4B4B4B4B4B4B4B4B4B4B4B4B4B4B4B4B4B4B4B4B4B4B43E3E3E463EB4B4B43EB43EB4B4B4B4B4B4B4B4B4B4B4B4B4B4B4B4B4B4B4B4B4B4B4B4B4B4B4B4B43E3E3D3D
