25,32,10,0,0
15,6
-1,-1
-1,-1
-1,-1
-1,-1
-1,-1
-1,-1
-1,-1
-1,-1
-1,-1
BEBFBFBFBF0E0E0E0E0E0EB5B50E0E0E0E0E0E0E0E0E0E0E0E
BEBEBFBF0E0EB4B40E0EB5B5B50E0E7878787878787878780E
BEBEBFBF0EB4B4B4B40EB5B50E0E0E78--------------780E
BEBEBFBFBF0EB4B40E0E0E0E0E0E0E78--------------780E
BEBEBEBEBFBF0E0E0E0E0EB60E0E0E787878----------780E
BFBEBEBEBEBF0E0E0E0EB6B6B60E0E0E0E78----------780E
BFBFBEBEBEBEBE040E0E0EB6B60E0E0E0E78----------780E
BFBFBFBFBEBEBE0404040E0E0E0E0E0E0E78----------780E
BFBFBFBFBFBF04040404040E0E0E0E0E0E787878787878780E
BFBFBFBFBFBF0E0E0404040404040E0E0E0E0E0E0E0E0E0E0E
BFBFBFBFBFBF0E0E0E0E0E04040404040E0E0E0E0E0E0E0E0E
BFBFBFBFBF0E0E0E0E0E0E0E0E040404040E0E0E0E0E0E0E0E
BFBFBFBFBFBF0E0E0E0E0E0E0E0E04040404040E0E0E0E0E0E
BFBFBFBF0E0E0E0E0E0E0E0E0E0E0404040404040E0E0E0E0E
BFBFBF0E0E0E0E0E0E0E0E0E040404040404040404040E0E0E
BFBFBF0E0E0E0E0E0E0E040404040404030404030404040E04
0EBF0E0E0E0E0E0E0E04040404040403030303030304040404
0E0E0E0E0E0E04040404040403040303030303030304040404
0E0E0E0E040E04040404030303030303030303030303040404
0E0E0E04040404040303030303030303030303030303030304
040E0404040403030303030303030303030303030303030303
04040404040303030303030303030303030303030303030303
03040404030303030303030303030303030303030303030303
03030404030303030303030303030303030303030303030303
03030303030303030303030303030303030303030303030303
03030303030303030303030303030303030303030303030303
03030303030303030303030303030303030303030303030303
03030303030303030303030303030303030303030303030303
03030303030303030303030303030303030303030303030303
03030303030303030303030303030303030303030303030303
03030303030303030303030303030303030303030303030303
03030303030303030303030303030303030303030303030303
