10,10,6,5,0
7F7F7F7F7F7F7F0E0E0E
7F7F0E7F0E0E0E0E0E0E
7F7F7F0E0E0E0E0E7E0E
7F7F7F0E0E0E0E0E0E0E
7F7F7F0E0E0E0E7F0E0E
7F7F0E0E0E0E0E0E0E7E
7E04040404040E0E0E0E
7E0404040404047E0E0E
7F0E0E0E0E0404040E0E
7F0E7F0E0E0E0404040E
