50,50,10,0,2
11,4
-1,-1
-1,-1
-1,-1
-1,-1
-1,-1
-1,-1
-1,-1
-1,-1
-1,-1
----------------------------------------------------------------------------------------------------
----------------------------------------------------------------------------------------------------
------------9696969696969696------------------------------------------------------------------------
------------9607070707070796------------------------------------------------------------------------
------------9607070707070796------------------------------------------------------------------------
------------9607070707070796------------------------------------------------------------------------
------------9607070707070796------------------------------------------------------------------------
------------9696070796969696------------------------------------------82828282----------------------
--------82828C960707968C82828282828282--------------------------------82090982----------------------
--------820908070707070809090909090982--------------------------------82090982----------------------
--------8C0807070707070708090909090982--------------------------------8209098296969696969696--------
--------960707070707070707080909090982--------------------------------8209098296070707070796--------
--------960707070707070707070809090982--------------------------------8C08098296070707070796--------
--------969696969696969696968C82090982------------828282828282828C8C8C9607088C96070707070796--------
------------------------------82090982------------8209090909090908088C9607079696070707070796--------
------------------------------8209088C------------820909090909090808080707070707070707070796--------
------------------9696969696968C080796------------820909090909090808080707070707070707070796--------
------------------96070707079696070796------------8209090909090908088C9607079696070707070796--------
------------------96070707070707070796------------820909090909090809829607088C96070707070796--------
------------------96070707070707070796------------828282090982828C82828C08098296969696969696--------
------------------960707070796960707969696969696968C82820909828282828282090982----------------------
------------------9607070707968C0807070707070707070809090909090909090909090982----------------------
------------------960707070796820908070707070707080909090909090909090909090982----------------------
------------------96969696969682828C9696960707968C8282828282828282828282090982----------------------
------------------------------------969696070796969696969696969696969682090982----------------------
------------------------------------960707070707070707070796960707079682090982----------------------
------------------------------------960707070707070707070707070707079682090982----------------------
------------------------------------960707070707070707070707070707079682090982------------82828282--
------------------------------------96070707070707070707079696070707968209088C------------82090982--
------------------------------------96070707070707070707079696969696968C080796------------82090982--
------------------------------------9607070707070707070707969696969696960707968C8C8282828282090982--
------------------------------------96070707070707070707079696070707070707070708080909098282090982--
------------------------------------96070707070707070707070707070707070707070708080909098282090982--
------------------------------------96070707070707070707070707070707070707070708080909090909090982--
------------------------------------96070707070707070707079696070707070707070708080909090909090982--
------------------------------------9696969696969696969696968C080707070707070708080909098282090982--
------------------------------------------------------------82090807070707070708080909098282090982--
------------------------------------------------------------82828C9696969696968C8C8282828282090982--
------------------------------------------------------------------------------------------82090982--
------------------------------------------------------------------------------------------82090982--
------------------------------------------------------------------------------------------82090982--
------------------------------------------------------------------------------------------82090982--
------------------------------------------------------------------------------------------82090982--
------------------------------------------------------------------------------------------8209098282
------------------------------------------------------------------------------------------8209090909
------------------------------------------------------------------------------------------8209090909
------------------------------------------------------------------------------------------8282828282
----------------------------------------------------------------------------------------------------
----------------------------------------------------------------------------------------------------
----------------------------------------------------------------------------------------------------
49,44,BPisland.map,3
49,45,BPisland.map,3
