22,17,10,3,1
3,4
-1,-1
-1,-1
-1,-1
-1,-1
-1,-1
-1,-1
-1,-1
-1,-1
-1,-1
78787878787878787878787878787878------------
78000000000000000000000000000078------------
78000000000000000000000000000078787878787878
78000000000000000000000000000078000000000078
78000000000000000000000000000078000000000078
78000000000000000000000000000000000000000078
78000000000000000000000000000000000000000078
78787878780000000000000000000000000000000078
--------780000000000000000000078000000000078
------78780000000000000000000078000000787878
------7800000000000000000000007800000078----
------7878787878787878787878787800000078----
------------------------------7800000078----
------------------------------783C3C3C78----
------------------------------783C3C3C78----
------------------------------783C3C3C78----
------------------------------783C3C3C78----
10,20,5,0
10,20,6,0
10,20,7,0
4,10,BPisland.map,2
