22,17,3,4,3
78787878787878787878787878787878------------
78000000000000000000000000000078------------
78000000000000000000000000000078787878787878
78000000000000000000000000000078000000000078
78000000000000000000000000000078000000000078
78000000000000000000000000000000000000000078
78000000000000000000000000000000000000000078
78787878780000000000000000000000000000000078
--------780000000000000000000078000000000078
--------780000000000000000000078000000787878
--------78000000000000000000007800000078----
--------78787878787878787878787800000078----
------------------------------7800000078----
------------------------------783C3C3C78----
------------------------------783C3C3C78----
------------------------------783C3C3C78----
------------------------------783C3C3C78----
10,20,5,0
10,20,6,0
10,20,7,0