64,64,31,3,0
82828282828282828282828282828282828282828282828282828282828282828282828282828282828282828282828282828282828282828282828282828282
82828282828282828282828282828282828282828282828282828282828282828282828282828282828282828282828282828282828282828282828282828282
82828282828282828282828282828282828282828282828282828282828282828282828282828282828282828282828282828282828282828282828282828282
828282787878787878787878787878787878787878787878787878787878780C0C78787878787878787878787878787878787878787878787878787878828282
828282780C0C0C0C0C0C0C0C0C0C0C0C0C0C0C0C0C0C0C0C0C0C0C0C0C0C0C0C0C0C0C0C0C0C0C0C0C0C0C0C0C0C0C0C0C0C0C0C0C0C0C0C0C0C0C0C78828282
828282780C0C0C0C0C0C0C0C0C0C0C0C0C0C0C0C0C0C0C0C0C0C0C0C0C0C0C0C0C0C0C0C0C0C0C0C0C0C0C0C0C0C0C0C0C0C0C0C0C0C0C0C0C0C0C0C78828282
828282780C0C787878787878780C0C7878787878787878780C0C7878787878787878780C0C780C0C787878787878780C0C780C0C780C0C7878780C0C78828282
828282780C0C0C0C0C0C0C0C0C0C0C780C0C0C0C0C0C0C780C0C780C0C780C0C0C0C780C0C780C0C780C0C780C0C780C0C780C0C780C0C780C0C0C0C78828282
828282780C0C0C0C0C0C0C0C0C0C0C780C0C0C0C0C0C0C780C0C780C0C780C0C0C0C780C0C780C0C780C0C780C0C0C0C0C780C0C0C0C0C780C0C0C0C78828282
828282780C0C787878787878787878780C0C0C0C0C0C0C780C0C780C0C780C0C0C0C780C0C780C0C780C0C780C0C0C0C0C780C0C0C0C0C780C0C787878828282
828282780C0C0C0C0C0C0C0C780C0C0C0C0C0C0C0C0C0C780C0C780C0C780C0C0C0C780C0C780C0C0C0C0C780C0C780C0C780C0C780C0C780C0C0C0C78828282
828282780C0C0C0C0C0C0C0C780C0C0C0C0C0C0C0C0C0C780C0C780C0C780C0C0C0C780C0C780C0C0C0C0C780C0C780C0C780C0C780C0C780C0C0C0C78828282
828282780C0C787878780C0C780C0C787878787878780C780C0C780C0C780C0C7878787878787878780C0C780C0C787878787878787878787878787878828282
828282780C0C780C0C780C0C780C0C0C0C0C780C0C780C780C0C780C0C0C0C0C0C0C0C0C0C0C0C0C0C0C0C780C0C0C0C0C0C0C0C0C0C0C0C0C0C0C0C78828282
828282787878780C0C780C0C780C0C0C0C0C780C0C780C780C0C780C0C0C0C0C0C0C0C0C0C0C0C0C0C0C0C780C0C0C0C0C0C0C0C0C0C0C0C0C0C0C0C78828282
828282780C0C0C0C0C0C0C0C780C0C780C0C780C0C780C787878780C0C7878787878787878787878787878787878787878787878787878787878787878828282
828282780C0C0C0C0C0C0C0C780C0C780C0C780C0C780C780C0C0C0C0C0C0C0C0C0C0C0C0C0C0C0C0C0C0C0C0C0C0C0C0C0C0C0C0C0C0C0C0C0C0C0C78828282
828282780C0C780C0C787878780C0C780C0C780C0C780C780C0C0C0C0C0C0C0C0C0C0C0C0C0C0C0C0C0C0C0C0C0C0C0C0C0C0C0C0C0C0C0C0C0C0C0C78828282
828282780C0C780C0C780C0C780C0C780C0C0C0C0C780C780C0C780C0C7878787878787878787878780C0C780C0C7878787878787878787878780C0C78828282
828282780C0C780C0C780C0C780C0C780C0C0C0C0C780C780C0C780C0C0C0C0C0C0C780C0C0C0C0C780C0C780C0C0C0C0C0C0C0C0C0C0C0C0C0C0C0C78828282
828282780C0C787878780C0C780C0C780C0C780C0C780C780C0C780C0C0C0C0C0C0C780C0C0C0C0C780C0C780C0C0C0C0C0C0C0C0C0C0C0C0C0C0C0C78828282
828282780C0C0C0C0C0C0C0C780C0C780C0C780C0C780C780C0C7878787878780C0C780C0C780C0C780C0C780C0C7878787878787878787878780C0C78828282
828282780C0C0C0C0C0C0C0C780C0C780C0C780C0C780C780C0C780C0C0C0C0C0C0C780C0C780C0C0C0C0C780C0C0C0C0C0C0C0C0C0C0C0C0C0C0C0C78828282
828282780C0C0C0C0C0C0C0C780C0C0C0C0C780C0C780C780C0C780C0C0C0C0C0C0C780C0C780C0C0C0C0C780C0C0C0C0C0C0C0C0C0C0C0C0C0C0C0C78828282
828282780C0C780C0C780C0C780C0C0C0C0C780C0C780C780C0C780C0C7878787878780C0C787878787878780C0C78787878780C0C78787878780C0C78828282
828282780C0C780C0C780C0C787878780C0C787878780C780C0C0C0C0C0C0C0C0C0C780C0C0C0C0C0C0C0C780C0C0C0C780C0C0C0C0C0C780C0C0C0C78828282
828282780C0C780C0C780C0C780C0C780C0C0C0C780C0C780C0C0C0C0C0C0C0C0C0C780C0C0C0C0C0C0C0C780C0C0C0C780C0C0C0C0C0C780C0C0C0C78828282
828282787878780C0C787878780C0C780C0C0C0C780C0C780C0C780C0C7878787878787878787878780C0C7878787878780C0C0C0C0C0C787878787878828282
828282780C0C0C0C0C0C0C0C780C0C7878780C0C780C0C780C0C780C0C7805050505780C0C0C0C0C0C0C0C780C0C0C0C780C0C0C0C0C0C0C0C0C0C0C78828282
828282780C0C0C0C0C0C0C0C780C0C780C0C0C0C780C0C780C0C780C0C7805050505780C0C0C0C0C0C0C0C780C0C0C0C780C0C0C0C0C0C0C0C0C0C0C78828282
828282780C0C0C0C0C0C0C0C780C0C780C0C0C0C780C0C780C0C780C0C7805050505780C0C787878780C0C780C0C7878787878787878787878780C0C78828282
828282780C0C780C0C780C0C780C0C780C0C7878780C0C780C0C780C0C7805050505780C0C780C0C0C0C0C780C0C0C0C0C0C0C0C0C0C0C0C0C0C0C0C78828282
828282780C0C780C0C780C0C780C0C0C0C0C0C0C780C0C780C0C780C0C7805050505780C0C780C0C0C0C0C780C0C0C0C0C0C0C0C0C0C0C0C0C0C0C0C78828282
828282780C0C780C0C780C0C780C0C0C0C0C0C0C780C0C780C0C780C0C7805050505780C0C787878787878787878787878787878787878787878787878828282
828282780C0C780C0C780C0C780C0C7878787878780C0C780C0C78787878780C0C78780C0C0C0C0C0C0C0C0C0C0C0C0C0C0C0C0C0C0C0C0C0C0C0C0C78828282
828282787878787878780C0C780C0C780C0C0C0C0C0C0C780C0C0C0C0C78780C0C78780C0C0C0C0C0C0C0C0C0C0C0C0C0C0C0C0C0C0C0C0C0C0C0C0C78828282
828282780C0C0C0C0C0C0C0C0C0C0C780C0C0C0C0C0C0C780C0C0C0C0C78780C0C78787878787878780C0C7878787878787878787878787878780C0C78828282
828282780C0C0C0C0C0C0C0C0C0C0C780C0C787878787878787878787878780C0C78780C0C780C0C0C0C0C0C0C0C0C0C0C0C0C0C0C0C0C0C0C780C0C78828282
828282780C0C787878787878787878780C0C780C0C820C0C820C0C820C0C820C0C82780C0C780C0C0C0C0C0C0C0C0C0C0C0C0C0C0C0C0C0C0C780C0C78828282
828282780C0C0C0C0C0C0C0C0C0C0C780C0C780C0C0C0C0C0C0C0C0C0C0C0C0C0C0C780C0C7878787878787878787878787878787878787878780C0C78828282
828282780C0C0C0C0C0C0C0C0C0C0C780C0C780C0C0C0C0C0C0C0C0C0C0C0C0C0C0C780C0C0C0C0C0C0C0C0C0C0C0C0C0C0C0C0C0C0C0C0C0C0C0C0C78828282
828282780C0C787878787878780C0C780C0C780C0C820C0C820C0C820C0C820C0C82780C0C0C0C0C0C0C0C0C0C0C0C0C0C0C0C0C0C0C0C0C0C0C0C0C78828282
828282780C0C0C0C0C0C0C0C0C0C0C780C0C780C0C78787878787878787878787878787878787878787878787878787878787878787878787878787878828282
828282780C0C0C0C0C0C0C0C0C0C0C780C0C780C0C780C0C0C0C0C0C0C0C0C780C0C0C0C0C0C0C0C0C0C0C0C0C0C0C0C0C0C0C0C780C0C0C0C0C0C0C78828282
828282780C0C787878787878787878780C0C780C0C780C0C0C0C0C0C0C0C0C780C0C0C0C0C0C0C0C0C0C0C0C0C0C0C0C0C0C0C0C780C0C0C0C0C0C0C78828282
828282780C0C0C0C0C0C0C0C0C0C0C780C0C780C0C780C0C78787878780C0C780C0C780C0C787878787878787878787878780C0C7878787878780C0C78828282
828282780C0C0C0C0C0C0C0C0C0C0C780C0C780C0C780C0C780C0C0C780C0C780C0C780C0C780C0C780C0C780C0C0C0C0C780C0C0C0C0C0C0C0C0C0C78828282
828282780C0C780C0C780C0C0C0C0C780C0C780C0C780C0C780C0C0C780C0C780C0C780C0C780C0C780C0C780C0C0C0C0C780C0C0C0C0C0C0C0C0C0C78828282
828282780C0C780C0C780C0C0C0C0C780C0C780C0C0C0C0C0C0C0C0C780C0C0C0C0C780C0C780C0C780C0C0C0C0C780C0C7878787878787878780C0C78828282
828282780C0C780C0C780C0C0C0C0C780C0C780C0C0C0C0C0C0C0C0C780C0C0C0C0C780C0C780C0C780C0C0C0C0C780C0C780C0C780C0C0C0C0C0C0C78828282
828282780C0C780C0C780C0C787878780C0C78787878787878787878787878780C0C787878780C0C780C0C787878780C0C780C0C780C0C0C0C0C0C0C78828282
828282780C0C780C0C780C0C780C0C780C0C780C0C780C0C780C0C0C0C0C0C780C0C780C0C780C0C780C0C0C0C0C0C0C0C780C0C780C0C787878787878828282
828282780C0C787878780C0C780C0C780C0C780C0C0C0C0C780C0C0C0C0C0C780C0C780C0C780C0C780C0C0C0C0C0C0C0C780C0C0C0C0C0C0C0C0C0C78828282
828282780C0C780C0C780C0C780C0C0C0C0C780C0C0C0C0C780C0C78787878780C0C780C0C0C0C0C780C0C780C0C787878780C0C0C0C0C0C0C0C0C0C78828282
828282780C0C780C0C780C0C780C0C0C0C0C780C0C780C0C780C0C780C0C0C0C0C0C780C0C0C0C0C780C0C780C0C0C0C0C7878787878787878780C0C78828282
828282780C0C780C0C780C0C780C0C780C0C780C0C780C0C780C0C780C0C0C0C0C0C780C0C780C0C780C0C780C0C0C0C0C780C0C0C0C0C0C0C0C0C0C78828282
828282780C0C780C0C780C0C780C0C780C0C780C0C780C0C780C0C780C0C0C0C0C0C780C0C780C0C780C0C780C0C780C0C780C0C0C0C0C0C0C0C0C0C78828282
828282780C0C780C0C787878780C0C787878780C0C780C0C780C0C78787878787878780C0C780C0C780C0C780C0C780C0C780C0C7878787878780C0C78828282
828282780C0C780C0C0C0C0C0C0C0C0C0C0C0C0C0C780C0C0C0C0C0C0C0C0C0C0C0C0C0C0C780C0C0C0C0C0C0C0C780C0C0C0C0C0C0C0C0C0C0C0C0C78828282
828282780C0C780C0C0C0C0C0C0C0C0C0C0C0C0C0C780C0C0C0C0C0C0C0C0C0C0C0C0C0C0C780C0C0C0C0C0C0C0C780C0C0C0C0C0C0C0C0C0C0C0C0C78828282
82828278787878787878787878787878787878787878787878787878787878787878787878787878787878787878787878787878787878787878787878828282
82828282828282828282828282828282828282828282828282828282828282828282828282828282828282828282828282828282828282828282828282828282
82828282828282828282828282828282828282828282828282828282828282828282828282828282828282828282828282828282828282828282828282828282
82828282828282828282828282828282828282828282828282828282828282828282828282828282828282828282828282828282828282828282828282828282
