10,10,7,7,0
FEFEFEFEFEFEFEFEFEFE
FE00FE000000000000FE
FE000000000000FEFEFE
FE000000000000FE00FE
FE0000FEFEFE000000FE
FE000000FEFE000000FE
FE0000000000000000FE
FE00FE000000000000FE
FE0000FE0000000000FE
FEFEFEFEFEFEFEFEFEFE
