83,83,19,6,17,0
--------------------------------------------------------82828282828282------------------------------------828282828282828282828282828282828282828282828282828282828282
82828282828282828282----------------------------828282828208080808088282828282----------------------------82020202020202B4B4B4B4B4B4B4B4B4B4B4B4B4B4B4B4B4B4B4B4B4B4B4
44444444444444444482----------------------------820808088208080808088208080882----------------------------820202020202B4B4B4B4B4B4B4B4B4B4B4B4B4B4B4B4B4B4B4B4B4B4B4B4
44444444444444444482----------------------------820808088208080808088208080882------828282828282828282828282020202020202B4B4B4B4B4B4B4B4B4B4B4B4B4B4B4B4B4B4B4B4B4B4B4
82828282828282444482----------828282828282828282820808088282080808828208080882------8202020202020202020202020202020202B4B4B4B4B4B4B4B4B4B4B4B4B4B4B4B4B4B4B4B4B4B4B4B4
------------82444482----------824444440808080808080808080808080808080808080882------8202020202020202020202020202020202B4B4B4B4B4B4B4B4B4B4B4B4B4B4B4B4B4B4B4B4B4B4B4B4
------------82444482----------824444440808080808080808080808080808080808080882------8202020202020202020202020202020202B4B4B4B4B4B4B4B4B4B4B4B4B4B4B4B4B4B4B4B4B4B4B4B4
------------824444828282828282824444828282828282828282828208088282828282828282828282820202020202020202020202020202020202B4B4B4B4B4B4B4B4B4B4B4B4B4B4B4B4B4B4B4B4B4B4B4
------------82444444444444444444444482------------82080808080882------820B0B0B0B0B0B0B0202020202020202B4020202020202020202B4B4B4B4B4B4B4B4B4B4B4B4B4B4B4B4B4B4B4B4B4B4
------------82444444444444444444444482------------82080808080882------820B3F3F0B0B0B020202020202020202B4B40202020202B402B4B4B4B4B4B4B4B4B4B4B4B4B4B4B4B4B4B4B4B4B4B4B4
------------82828282828282828282828282------------82080808080882------820B3F3F0B0A020202020202020202B4B4B4B402020202B4B4B4B4B4B4B4B4B4B4B4B4B4B4B4B4B4B4B4B4B4B4B4B4B4
----------------------------------------828282828282828282080882828282820B0B0B0B02020202B4B402020202B4B4B4B4B40202B4B4B4B4B4B4B4B4B4B4B4B4B4B4B4B4B4B4B4B4B4B4B4B4B4B4
----------------------------------------820202020202020282080808080808080B0B0B02020202B4B4B4B4B4020202B4B4B4B4B4B4B4B4B4B4B4B4B4B4B4B4B4B4B4B4B4B4B4B4B4B4B4B4B4B4B4B4
----------------------------------------820202020202020282080808080808080B0A0202020202B4B4B4B4B402020202B4B4B4B4B4B4B4B4B4B4B4B4B4B4B4B4B4B4B4B4B4B4B4B4B4B4B4B4B4B4B4
----------------------------------------820202020202020282828282828282820A0202020202B4B4B4B4B4B4B402020202B4B4B4B4B4B4B4B4B4B4B4B4B4B4B4B4B4B4B4B4B4B4B4B4B4B4B4B4B4B4
8282828282828282828282828282828282828282820202020202020202020202020202020202020202B4B4B4B4B4B4B4B4020202B4B4B4B4B4B4B4B4B4B4B4B4B4B4B4B4B4B4B4B4B4B4B4B4B4B4B4B4B4B4B4
3E3E3E3E3E3E3E3E3E3E3E3E3E3E3E3E3E3EB40202020202020202020202020202020202020202020202B4B4B4B4B4B40202020202B4B4B402B4B4B4B4B4B4B4B4B4B4B4B4B4B4B4B4B4B4B4B4B4B4B4B4B4B4
B43E3EB43E3E3E3E3E3E3E3E3E3E3E3EB4B4B4B402020202020202B4B40202020202020202020202020202B4B4B4B402020202020202B4020202B4B4B4B4B4B4B4B4B4B4B4B4B4B4B4B4B4B4B4B4B4B4B4B4B4
B4B4B4B4B43EB43E3E3E3E3E3EB4B4B4B4B4B4B4020202020202B4B4B4B4B40202020202020202020202020202B402020202020202020202020202B4B4B4B4B4B4B4B4B4B4B4B4B4B4B4B4B4B4B4B4B4B4B4B4
B4B4B4B4B43EB4B4B43E3E3EB4B4B4B4B4B4B4B4B402020202B4B4B4B4B4B4B402020202020202020202020202020202020202020202020202020202B4B4B4B4B4B4B4B4B4B4B4B4B4B4B4B4B4B4B4B4B4B4B4
B4B4B4B4B4B4B4B4B4B4B4B4B4B4B4B4B4B4B4B4B4B4020202B4B4B4B4B4B4B4B4B4B4B4020202B4B4020202020202B4B40202B402020202020202B4B4B4B4B4B4B4B4B4B4B4B4B4B4B4B4B4B4B4B4B4B4B4B4
B4B4B4B4B4B4B4B4B4B4B4B4B4B4B4B4B4B4B4B4020202020202B4B4B4B4B4B4B4B4B4B4B402B4B4B4B402020202B4B4B4B4B4B4B40202020202B4B4B4B4B4B4B4B4B4B4B4B4B4B4B4B4B4B4B4B4B4B4B4B4B4
B4B4B4B4B4B4B4B4B4B4B4B4B4B4B4B4B4B4B40202020202020202B4B4B4B4B4B4B4B4B4B4B4B4B4B4B4B402020202B4B4B4B4B4B40202020202B4B4B4B4B4B4B4B4B4B4B4B4B4B4B4B4B4B4B4B4B4B4B4B4B4
B4B4B4B4B4B4B4B4B4B4B4B4B4B4B4B4B4B4B4B40202020202020202B4B4B4B4B402B4B4B4B4B4B4B4B4B402020202B4B4B4B4B40202020202B4B4B4B4B4B4B4B4B4B4B4B4B4B4B4B4B4B4B4B4B4B4B4B4B4B4
B4B4B4B4B4B4B4B4B4B4B4B4B4B4B4B4B4B4B4B4B402020202020202B4B4B4B4020202B4B4B4B4B4B4B40202020202B4B4B4B4B4B4B4020202B4B4B4B4B4B4B4B4B4B4B4B4B4B4B4B4B4B4B4B4B4B4B4B4B4B4
B4B4B4B4B4B4B4B4B4B4B4B4B4B4B4B4B4B4B4B4B4B40202020202B4B4B4B4B4020202B4B40202B4B402020202020202B4B4B402B4B4020202B4B4B4B4B4B4B4B4B4B4B4B4B4B4B4B4B4B4B4B4B4B4B4B4B4B4
B4B4B4B4B4B4B4B4B4B4B4B4B4B4B4B4B4B4B4B4B4B4B4020202B4B4B4B4B4B4B4020202020202020202020202020202B4B402020202020202B4B4B4B4B4B4B4B4B4B4B4B4B4B4B4B4B4B4B4B4B4B4B4B4B4B4
B4B4B4B4B4B4B4B4B4B4B4B4B4B4B4B4B4B4B4B4B4B4B4020202B4B4B4B4B4B4B402020202020202020202020202020202020202020202B4B4B4B4B4B4B4B4B4B4B4B4B4B4B4B4B4B4B4B4B4B4B4B4B4B4B4B4
B4B4B4B4B4B4B4B4B4B4B4B4B4B4B4B4B4B4B4B4B4B4020202B4B4B4B4B4B4B4020202B4B4B402020202020202020202B4B4020202B4B4B4B4B4B4B4B4B4B4B4B4B4B4B4B4B4B4B4B4B4B4B4B4B4B4B4B4B4B4
B4B4B4B4B4B4B4B4B4B4B4B4B4B4B4B4B4B4B4B4B4020202020202B4B4B4B402020202B4B4B4020202020202020202B4B4B4B402B4B4B4B4B4B4B4B4B4B4B4B4B4B4B4B4B4B4B4B4B4B4B4B4B4B4B4B4B4B4B4
B4B4B4B4B4B4B4B4B4B4B4B4B4B4B4B4B4B4B4B402020202020202B4B4B4B4B4020202B4B40202020202B4B4B4B4B4B4B4B4B402B4B4B4B4B4B4B4B4B4B4B4B4B4B4B4B4B4B4B4B4B4B4B4B4B4B4B4B4B4B4B4
B4B4B4B4B4B4B4B4B4B4B4B4B4B4B4B4B4B4B4B40202020202020202B4B4B4B4B40202020202020202B4B4B4B4B4B4B4B4B40202B4B4B4B4B4B4B4B4B4B4B4B4B4B4B4B4B4B4B4B4B4B4B4B4B4B4B4B4B4B4B4
B4B4B4B4B4B4B4B4B4B4B4B4B4B4B4B4B4B4B4B4B4020202B4B4020202B4B4B4B402020202020202B4B4B4B4B4B4B4B40202020202B4B4B4B4B4B4B4B4B4B4B4B4B4B4B4B4B4B4B4B4B4B4B4B4B4B4B4B4B4B4
B4B4B4B4B4B4B4B4B4B4B4B4B4B4B4B4B4B4B4B4020202B4B4B4B4020202B4B4B4B4020202020202B4B4B4B4B402020202020202020202B4B4B4B4B4B4B4B4B4B4B4B4B4B4B4B4B4B4B4B4B4B4B4B4B4B4B4B4
B4B4B4B4B4B4B4B4B4B4B4B4B4B4B4B4B4B4B402020202B4B4B4B402020202B4B4B4B402B4B40202B4B4B4B4B402020202B4B4B402020202B4B4B4B4B402B4B4B4B4B4B4B4B4B4B4B4B4B4B4B4B4B4B4B4B4B4
B4B4B4B4B4B4B4B4B4B4B4B4B4B4B4B4B4B4B4B4020202B4B4B4B402020202B4B4B4B4B4B4B40202B4B4B4B402020202B4B4B4B4B402020202B4B4020202B4B4B4B4B4B4B4B4B4B4B4B4B4B4B4B4B4B4B4B4B4
B4B4B4B4B4B4B4B4B4B4B4B4B4B4B4B4B4B4B4B4B4020202B4B402020202B4B4B4B4B4B4B402020202B4B4B4020202B4B4B4B4B4B4B40202020202020202B4B4B4B4B4B4B4B4B4B4B4B4B4B4B4B4B4B4B4B4B4
B4B4B4B4B4B4B4B4B4B4B4B4B4B4B4B4B4B4B4B402020202020202020202B4B4B4B4B4B4B40202020202020202020202B4B4B4B4B4B402020202020202B4B4B4B4B4B4B4B4B4B4B4B4B4B4B4B4B4B4B4B4B4B4
B4B4B4B4B4B4B4B4B4B4B4B4B4B4B4B4B4B4B4B402020202B40202020202B4B4B4B4B4B4B4B40202020202020202020202B4B4B4B40202020202020202B4B4B4B4B4B4B4B4B4B4B4B4B4B4B4B4B4B4B4B4B4B4
B4B4B4B4B4B4B4B4B4B4B4B4B4B4B4B4B4B4B4B4B40202B4B4B40202020202B4B4B4B4B4B4B4020202020202020202020202B4B4020202020202020202B4B4B4B4B4B4B4B4B4B4B4B4B4B4B4B4B4B4B4B4B4B4
B4B4B4B4B4B4B4B4B4B4B4B4B4B4B4B4B4B4B4B4B4B4B4B4B402020202020202B4B4B4B4B4B4B402020202020202020202B4B4B4B4020202020202B4B4B4B4B4B4B4B4B4B4B4B4B4B4B4B4B4B4B4B4B4B4B4B4
B4B4B4B4B4B4B4B4B4B4B4B4B4B4B4B4B4B4B4B4B4B4B40202020202020202020202B4B4B4B4B4B40202B4B40202020202B4B4B4B402020202B4B4B4B4B4B4B4B4B4B4B4B4B4B4B4B4B4B4B4B4B4B4B4B4B4B4
B4B4B4B4B4B4B4B4B4B4B4B4B4B4B4B4B4B4B4B4B4B4B4B40202020202020202020202B4B4B4B4B402B4B4B4020202020202B4B402020202B4B4B4B4B4B4B4B4B4B4B4B4B4B4B4B4B4B4B4B4B4B4B4B4B4B4B4
B4B4B4B4B4B4B4B4B4B4B4B4B4B4B4B4B4B4B4B4B4B4B4B4B402020202020202020202B4B4B4B4B4B4B4B40202020202020202020202020202B4B4B4B4B4B4B4B4B4B4B4B4B4B4B4B4B4B4B4B4B4B4B4B4B4B4
B4B4B4B4B4B4B4B4B4B4B4B4B4B4B4B4B4B4B4B4B4B4B4B4B4B40202020202020202B4B4B4B4B4B4B4B4B4B4B402020202020202020202020202B4B4B4B4B4B4B4B4B4B4B4B4B4B4B4B4B4B4B4B4B4B4B4B4B4
B4B4B4B4B4B4B4B4B4B4B4B4B4B4B4B4B4B4B4B4B4B4B4B4B40202020202020202B4B4B4B4B4B4B4B4B4B4B4B4B402B4020202020202020202B4B4B4B4B4B4B4B4B4B4B4B4B4B4B4B4B4B4B4B4B4B4B4B4B4B4
B4B4B4B4B4B4B4B4B4B4B4B4B4B4B4B4B4B4B4B4B4B4B4B40202020202020202B4B4B4B4B4B4B4B4B4B4B4B4B4B4B4B4B40202020202020202B4B4B4B4B4B4B4B4B4B4B4B4B4B4B4B4B4B4B4B4B4B4B4B4B4B4
B4B4B4B4B4B4B4B4B4B4B4B4B4B4B4B4B4B4B4B4B4B4B4B4B4020202020202B4B4B4B4B4B4B4B4B4B4B4B4B4B4B4B4B4B4B40202020202020202B4B4B4B4B4B4B4B4B4B4B4B4B4B4B4B4B4B4B4B4B4B4B4B4B4
B4B4B4B4B4B4B4B4B4B4B4B4B4B4B4B4B4B4B4B4B4B4B4B4B4020202020202B4B4B4B4B4B4B4B4B4B4B4B4B4B4B4B4B4B402020202020202020202B4B4B4B4B4B4B4B4B4B4B4B4B4B4B4B4B4B4B4B4B4B4B4B4
B4B4B4B4B4B4B4B4B4B4B4B4B4B4B4B4B4B4B4B4B4B402B402020202020202B4B4B4B4B4B4B4B4B4B4B4B4B4B4B402B40202020202B4B402020202B4B4B4B4B4B4B4B4B4B4B4B4B4B4B4B4B4B4B4B4B4B4B4B4
B4B4B4B4B4B4B4B4B4B4B4B4B4B4B4B4B4B4B4B4B402020202020202020202B4B4B4B4B4B4B4B4B4B4B4B4B4B4B4020202020202B4B4B4B402020202B4B4B4B4B4B4B4B4B4B4B4B4B4B4B4B4B4B4B4B4B4B4B4
B4B4B4B4B4B4B4B4B4B4B4B4B4B4B4B4B4B4B4B4B4B402020202020202020202B4B4B4B402B4B4B4B4B4B4B4B4020202020202B4B4B4B4B4B4020202B4B4B4B4B4B4B4B4B4B4B4B4B4B4B4B4B4B4B4B4B4B4B4
B4B4B4B4B4B4B4B4B4B4B4B4B4B4B4B4B4B4B4B4B4B4B402020202B4B402020202B4B4020202B4B4B4B4B4B402020202020202B4B4B4B4B4B402020202B4B4B4B4B4B4B4B4B4B4B4B4B4B4B4B4B4B4B4B4B4B4
B4B4B4B4B4B4B4B4B4B4B4B4B4B4B4B4B4B4B4B4B4B4B4B40202B4B4B4B4020202020202020202B4B4B40202020202B4B40202B4B4B4B4B4020202020202B4B4B4B4B4B4B4B4B4B4B4B4B4B4B4B4B4B4B4B4B4
B4B4B4B4B4B4B4B4B4B4B4B4B4B4B4B4B4B4B4B4B4B4B4020202B4B4B4B402020202020202020202B40202020202B4B4B402020202B4B40202020202020202B4B4B4B4B4B4B4B4B4B4B4B4B4B4B4B4B4B4B4B4
B4B4B4B4B4B4B4B4B4B4B4B4B4B4B4B4B4B4B4B4B4020202020202B4B40202020202020202020202020202020202B4B4B4020202020202020202020202020202B4B4B4B4B4B4B4B4B4B4B4B4B4B4B4B4B4B4B4
B4B4B4B4B4B4B4B4B4B4B4B4B4B4B4B4B4B4B4B4020202020202020202020202020202020202020202020202020202B4B4B4020202020202020202020202020202B4B4B4B4B4B4B4B4B4B4B4B4B4B4B4B4B4B4
B4B4B4B4B4B4B4B4B4B4B4B4B4B4B4B4B4B4B4B4B4B402B40202020202020202020202020202020202020202020202B4B402020202B40202020202B4B402020202B4B4B4B4B4B4B4B4B4B4B4B4B4B4B4B4B4B4
B4B4B4B4B4B4B4B4B4B4B4B4B4B4B4B4B4B4B4B4B4B4B4B4B402020202B4B40202020202B4B40202020202020202020202020202B4B4B4B40202B4B4B4B4020202B4B4B4B4B4B4B4B4B4B4B4B4B4B4B4B4B4B4
B4B4B4B4B4B4B4B4B4B4B4B4B4B4B4B4B4B4B4B4B4B4B4020202B402B4B4B4B4020202B4B4B4B40202B4020202B402020202020202B4B4B4B4B4B4B4B4B40202B4B4B4B4B4B4B4B4B4B4B4B4B4B4B4B4B4B4B4
B4B4B4B4B4B4B4B4B4B4B4B4B4B4B4B4B4B4B4B4B4B4B4B40202B4B4B4B4B4B4020202B4B4B4B4B4B4B4020202B4B402020223230202B4B4B4B4B4B4B4B4B4B4B4B4B4B4B4B4B4B4B4B4B4B4B4B4B4B4B4B4B4
B4B4B4B4B4B4B4B4B4B4B4B4B4B4B4B4B4B4B4B4B4B4B4B4B4B4B4B4B4B4B40202020202B4B4B4B4B4020202B4B4B4B402A12323A102B4B4B4B4B4B4B4B4B4B4B4B4B4B4B4B4B4B4B4B4B4B4B4B4B4B4B4B4B4
B4B4B4B4B4B4B4B4B4B4B4B4B4B4B4B4B4B4B4B4B4B4B4B4B4B4B4B4B4B4B4B4B4B4B4B4B4B4B4B4B4B4B4B4B4B4B4B402A12323A1B4B4B4B4B4B4B4B4B4B4B4B4B4B4B4B4B4B4B4B4B4B4B4B4B4B4B4B4B4B4
B4B4B4B4B4B4B4B4B4B4B4B4B4B4B4B4B4B4B4B4B4B4B4B4B4B4B4B4B4B4B4B4B4B4B4B4B4B4B4B4B4B4B4B4B4B4B4B4B4A12323A1B4B4B4B4B4B4B4B4B4B4B4B4B4B4B4B4B4B4B4B4B4B4B4B4B4B4B4B4B4B4
B4B4B4B4B4B4B4B4B4B4B4B4B4B4B4B4B4B4B4B4B4B4B4B4B4B4B4B4B4B4B4B4B4B4B4B4B4B4B4B4B4B4B4B4B4B4B4B4B4A15F5FA1B4B4B4B4B4B4B4B4B4B4B4B4B4B4B4B4B4B4B4B4B4B4B4B4B4B4B4B4B4B4
B4B4B4B4B4B4B4B4B4B4B4B4B4B4B4B4B4B4B4B4B4B4B4B4B4B4B4B4B4B4B4B4B4B4B4B4B4B4B4B4B4B4B4B4B4B4B4B4B4A15F5FA1B4B4B4B4B4B4B4B4B4B4B4B4B4B4B4B4B4B4B4B4B4B4B4B4B4B4B4B4B4B4
B4B4B4B4B4B4B4B4B4B4B4B4B4B4B4B4B4B4B4B4B4B4B4B4B4B4B4B4B4B4B4B4B4B4B4B4B4B4B4B4B4B4B4B4B4B4B4B4B4A15F5FA1B4B4B4B4B4B4B4B4B4B4B4B4B4B4B4B4B4B4B4B4B4B4B4B4B4B4B4B4B4B4
B4B4B4B4B4B4B4B4B4B4B4B4B4B4B4B4B4B4B4B4B4B4B4B4B4B4B4B4B4B4B4B4B4B4B4B4B4B4B4B4B4B4B4B4B4B4B4B4B4A15F5FA1B4B4B4B4B4B4B4B4B4B4B4B4B4B4B4B4B4B4B4B4B4B4B4B4B4B4B4B4B4B4
B4B4B4B4B4B4B4B4B4B4B4B4B4B4B4B4B4B4B4B4B4B4B4B4B4B4B4B4B4B4B4B4B4B4B4B4B4B4B4B4B4B4B4B4B4B4B4B4B4A15F5FA1B4B4B4B4B4B4B4B4B4B4B4B4B4B4B4B4B4B4B4B4B4B4B4B4B4B4B4B4B4B4
B4B4B4B4B4B4B4B4B4B4B4B4B4B4B4B4B4B4B4B4B4B4B4B4B4B4B4B4B4B4B4B4B4B4B4B4B4B4B4B4B4B4B4B4B4B4B4B4B4A15F5FA1B4B4B4B4B4B4B4B4B4B4B4B4B4B4B4B4B4B4B4B4B4B4B4B4B4B4B4B4B4B4
B4B4B4B4B4B4B4B4B4B4B4B4B4B4B4B4B4B4B4B4B4B4B4B4B4B4B4B4B4B4B4B4B4B4B4B4B4B4B4B4B4B4B4B4B4B4B4B4B4A15F5FA1B4B4B4B4B4B4B4B4B4B4B4B4B4B4B4B4B4B4B4B4B4B4B4B4B4B4B4B4B4B4
B4B4B4B4B4B4B4B4B4B4B4B4B4B4B4B4B4B4B4B4B4B4B4B4B4B4B4B4B4B4B4B4B4B4B4B4B4B4B4B4B4B4B4B4B4B4B4B4B4A15F5FA1B4B4B4B4B4B4B4B4B4B4B4B4B4B4B4B4B4B4B4B4B4B4B4B4B4B4B4B4B4B4
B4B4B4B4B4B4B4B4B4B4B4B4B4B4B4B4B4B4B4B4B4B4B4B4B4B4B4B4B4B4B4B4B4B4B4B4B4B4B4B4B4B4B4B4B4B4B4B4B4A15F5FA1B4B4B4B4B4B4B4B4B4B4B4B4B4B4B4B4B4B4B4B4B4B4B4B4B4B4B4B4B4B4
B4B4B4B4B4B4B4B4B4B4B4B4B4B4B4B4B4B4B4B4B4B4B4B4B4B4B4B4B4B4B4B4B4B4B4B4B4B4B4B4B4B4B4B4B4B4B4B4B4A15F5FA1B4B4B4B4B4B4B4B4B4B4B4B4B4B4B4B4B4B4B4B4B4B4B4B4B4B4B4B4B4B4
B4B4B4B4B4B4B4B4B4B4B4B4B4B4B4B4B4B4B4B4B4B4B4B4B4B4B4B4B4B4B4B4B4B4B4B4B4B4B4B4B4B4B4B4B4B4B4B4B4A15F5FA1B4B4B4B4B4B4B4B4B4B4B4B4B4B4B4B4B4B4B4B4B4B4B4B4B4B4B4B4B4B4
B4B4B4B4B4B4B4B4B4B4B4B4B4B4B4B4B4B4B4B4B4B4B4B4B4B4B4B4B4B4B4B4B4B4B4B4B4B4B4B4B4B4B4B4B4B4B4B4B4A15F5FA1B4B4B4B4B4B4B4B4B4B4B4B4B4B4B4B4B4B4B4B4B4B4B4B4B4B4B4B4B4B4
B4B4B4B4B4B4B4B4B4B4B4B4B4B4B4B4B4B4B4B4B4B4B4B4B4B4B4B4B4B4B4B4B4B4B4B4B4B4B4B4B4B4B4B4B4B4B4B4B4A15F5FA1B4B4B4B4B4B4B4B4B4B4B4B4B4B4B4B4B4B4B4B4B4B4B4B4B4B4B4B4B4B4
B4B4B4B4B4B4B4B4B4B4B4B4B4B4B4B4B4B4B4B4B4B4B4B4B4B4B4B4B4B4B4B4B4B4B4B4B4B4B4B4B4B4B4B4B4B4B4B4B4A15F5FA1B4B4B4B4B4B4B4B4B4B4B4B4B4B4B4B4B4B4B4B4B4B4B4B4B4B4B4B4B4B4
B4B4B4B4B4B4B4B4B4B4B4B4B4B4B4B4B4B4B4B4B4B4B4B4B4B4B4B4B4B4B4B4B4B4B4B4B4B4B4B4B4B4B4B4B4B4B4B4B4A15F5FA1B4B4B4B4B4B4B4B4B4B4B4B4B4B4B4B4B4B4B4B4B4B4B4B4B4B4B4B4B4B4
B4B4B4B4B4B4B4B4B4B4B4B4B4B4B4B4B4B4B4B4B4B4B4B4B4B4B4B4B4B4B4B4B4B4B4B4B4B4B4B4B4B4B4B4B4B4B4B4B4A15F5FA1B4B4B4B4B4B4B4B4B4B4B4B4B4B4B4B4B4B4B4B4B4B4B4B4B4B4B4B4B4B4
B4B4B4B4B4B4B4B4B4B4B4B4B4B4B4B4B4B4B4B4B4B4B4B4B4B4B4B4B4B4B4B4B4B4B4B4B4B4B4B4B4B4B4B4B4B4B4B4B4A15F5FA1B4B4B4B4B4B4B4B4B4B4B4B4B4B4B4B4B4B4B4B4B4B4B4B4B4B4B4B4B4B4
B4B4B4B4B4B4B4B4B4B4B4B4B4B4B4B4B4B4B4B4B4B4B4B4B4B4B4B4B4B4B4B4B4B4B4B4B4B4B4B4B4B4B4B4B4B4B4B4B4A15F5FA1B4B4B4B4B4B4B4B4B4B4B4B4B4B4B4B4B4B4B4B4B4B4B4B4B4B4B4B4B4B4
B4B4B4B4B4B4B4B4B4B4B4B4B4B4B4B4B4B4B4B4B4B4B4B4B4B4B4B4B4B4B4B4B4B4B4B4B4B4B4B4B4B4B4B4B4B4B4B4B4A15F5FA1B4B4B4B4B4B4B4B4B4B4B4B4B4B4B4B4B4B4B4B4B4B4B4B4B4B4B4B4B4B4
10,26,3,0
10,31,2,0
10,36,3,0
10,27,9,0
10,55,6,0
10,55,20,0
10,35,17,0
10,42,27,0
10,23,23,0
10,29,43,0
10,27,49,0
10,33,55,0
10,42,56,0
10,62,56,0
10,53,45,0
10,56,38,0
10,46,39,0
