83,80,1,62,0
------7A7A7A7A7A7A7A7A7A7A7A7A7A7A7A7A7A7A7A7A7A7A7A7A7A7A7A7A7A7A7A7A7A7A7A7A7A7A7A7A7A7A7A7A7A7A7A7A7A7A7A7A7A7A7A7A7A7A7A7A7A7A7A7A7A7A7A7A7A7A7A7A7A7A7A7A7A7A7A7A
------7A0202020202020202020202027A02020202020202027A0202020202020202020202020202027A7A7A7A7A02020202027A02020202027A02027A02027A02020202027A7A02020202020202020202027A
------7A0202020202020202020202027A02020202020202027A02020202020A020202020202020202020202020202020202027A02020202027A02027A02027A02020202027A7A02020202020202020202027A
------7A02027A7A7A7A7A7A7A7A02027A02027A02027A02027A02027A7A7A7A7A02027A02027A0202020202020202027A02020202027A02027A02027A02027A02027A0202020202027A02027A02027A02027A
------7A02027A0202020202027A02027A02027A02027A02027A02027A020A0A7A02027A02027A7A7A7A7A7A7A7A7A7A7A02020202027A02027A02027A0A0A7A02027A0202020202027A0A027A02027A02027A
------7A02027A0202020202027A02027A02027A02027A02020202027A020A0A0A02027A020202027A020202020202020202027A02027A02027A02027A020A0202027A7A7A7A7A7A7A7A02027A02027A02027A
------7A02027A02027A7A02027A02027A02027A02027A02020202027A0A0A0A0A0A027A020202027A020202020202020202027A02027A02027A02027A02020A0A027A020202020A0A7A02027A02027A02027A
------7A02027A0202027A02027A02027A02027A02027A02027A02027A7A7A7A7A7A7A7A7A7A02027A7A7A7A7A7A7A7A7A7A7A7A02027A02027A02027A02027A0A0A7A0A0A0A0A0A027A02027A02027A02027A
------7A02027A0202027A02027A02020202027A02027A02027A0202020A0A7A0A0A0202027A02027A020202020202020202020202027A02020202027A02027A0A0A7A0A0A7A7A0A027A02027A02027A02027A
------7A02027A0202027A02027A02020202027A02027A02027A02020A0A0A7A0A0A0A02027A02027A020202020202020202020202027A02020202027A02027A0A0A7A0A0A7A0A0A0A7A02027A02027A02027A
------7A02027A7A7A7A7A02027A7A7A7A7A7A7A7A7A7A02027A7A7A7A7A7A7A0A0A7A0A027A02027A7A7A7A7A7A7A7A7A7A7A7A7A7A7A7A7A7A7A7A7A02027A0A027A0A0A7A020A0A7A02027A02027A02027A
------7A0202020202020202020202020202020202020202027A020A0A0A0A7A0A0A7A0A027A02020202027A020202020202020202020202027A020202020A7A0A020A0A0A7A020A0A7A02027A02027A02027A
------7A0202020202020202020202020202020202020202027A020A0A0A0A7A0A0A7A0A027A02020202027A020202020202020202020202027A020202020A7A0A0A0A0A0A7A0A0A0A7A02027A02027A02027A
------7A7A7A7A7A7A7A7A02027A7A7A7A7A7A7A7A7A7A7A7A7A020A7A0A0A7A0A0A7A0A027A02027A02027A02027A7A7A7A7A7A7A7A7A02027A02027A7A7A7A7A7A7A7A7A7A0A0A7A7A7A7A7A02027A7A7A7A
------7A0202020202020202020202020202020202020202020202027A0A0A7A0A0A7A02027A02027A02027A02027A020202020202020202027A02027A020A0A0A0A7A0A0A7A0A0A0A0A02027A02020202027A
------7A0202020202020202020202020202020202020202020202027A0A0A7A0A0A7A02027A02027A02027A02027A020202020202020202027A02027A02020A0A0A7A0A0A7A0A0A0A0202027A02020202027A
------7A02027A7A7A7A7A7A7A7A7A7A7A7A7A7A7A7A7A7A7A7A7A7A7A020A7A0A027A02027A02027A02027A02027A02027A7A7A7A7A7A7A7A7A02027A02027A0A0A7A0A0A7A0A0A7A7A7A7A7A7A7A7A02027A
------7A02027A0202020202020202020202020202020202027A02027A02027A02027A02027A02027A02020202027A020202020202020202020202027A02027A0A0A0A0A0A7A0A0A020202020202027A02027A
------7A02027A0202020202020202020202020202020202027A02027A02027A02027A02027A02027A02020202027A020202020202020202020202027A02027A0A0A020A027A0A0A020202020202027A02027A
------7A02027A02027A7A7A7A7A7A7A7A7A7A7A7A7A7A7A7A7A02027A02027A02027A7A7A7A02027A7A7A7A7A7A7A7A7A7A7A7A7A7A7A7A7A7A02027A02027A7A7A7A7A7A7A7A7A7A7A7A7A7A7A7A7A02027A
------7A02027A0202020202020202020202020202020202027A02027A02027A02020202027A020202020202020202020202020202020202020202027A020202020A0A0A0A0A0A02020202020202020202027A
------7A02027A0202020202020202020202020202020202027A02027A02027A02020202027A020202020202020202020202020202020202020202027A020202020A0A0A0A0A0A02020202020202020202027A
------7A02027A7A7A7A7A7A7A7A7A7A7A7A02027A7A7A02027A02027A02027A7A7A7A02027A02027A7A7A7A7A7A7A7A7A7A7A7A7A7A7A7A7A7A7A7A7A02027A7A7A7A7A7A7A7A7A7A7A7A7A7A7A7A7A7A7A7A
------7A02027A0202020202020202020202020202027A02027A02027A02027A02020202027A02027A02020202027A020202020202020202020202027A02027A0202020A02020202020202027A02020202027A
------7A02027A0202020202020202020202020202027A02027A02027A02027A02020202027A02027A02020202027A020202020202020202020202027A02027A0202020A02020202020202027A02020202027A
------7A02027A02027A7A7A7A7A7A7A7A7A7A7A02027A02027A02027A02027A02027A7A7A7A02027A02027A02027A02027A7A7A7A02027A7A7A7A7A7A02027A7A7A7A7A7A7A7A7A7A7A02027A02027A02027A
------7A02027A0202020202020202020202020202027A02027A02027A02027A02020202027A02027A02027A02027A02020202020202027A020202020202020202020A0A0A020202020202027A02027A02027A
------7A02027A0202020202020202020202020202027A02027A02027A02027A02020202027A02027A02027A02027A02020202020202027A020202020202020202020A0A0A020202020202027A02027A02027A
------7A02027A7A7A7A7A7A02027A7A7A7A7A7A7A7A7A02027A02027A02027A7A7A7A02027A02027A02027A02027A7A7A7A7A7A7A02027A02027A7A7A7A7A7A7A7A7A7A7A7A7A7A7A7A7A7A7A02027A02027A
------7A0202020202020202020202020202020202027A02020202027A02020202020202027A02020202027A02020202020202020202027A020202020202020A020A0A0A0A0A020A020202020202027A02027A
------7A02020A0A0A020202020202020202020202027A02020202027A02020202020202027A02020202027A02020202020202020202027A02020202020202020A0A0A0A0A0A0A02020202020202027A02027A
------7A7A7A7A7A7A7A7A7A7A7A7A7A7A7A7A7A02027A7A7A7A7A7A7A7A7A7A7A7A7A7A7A7A7A7A7A7A7A7A7A7A7A7A7A7A7A7A7A7A7A7A7A7A7A7A7A7A7A7A7A7A7A7A7A7A7A7A7A7A7A7A7A7A7A7A02027A
------7A020A0A0A0A0A027A0202020202020202020202020202020A0A02020202020A0A02027A01010101010101010101010101017A020202020202020202020A0A0A0A0A0A0A02020202020202020202027A
------7A0A0A0A0A0A0A0A7A02020A0A02020202020A0A020A0A020A0A020202020A0A0A0A027A01010101010101010101010101017A02020202020202020A020A0A0A0A0A0A0A020A0202020202020202027A
------7A020A7A7A7A7A7A7A020A7A7A7A7A7A7A7A7A7A7A7A7A7A7A7A7A7A7A7A7A7A7A7A7A7A01010101010101010101010101017A02027A7A7A7A7A7A7A7A7A0A0A7A7A7A7A7A7A7A7A7A7A7A7A7A7A7A7A
------7A020A7A0A0A0A0A0202020A0A0A0202020A0A0A02020A0A0A0A0A0A020A0A0A0A0A027A01010101010101010101010101017A02020202027A0202020A0A0A0A7A0A0A0A0A020202027A02020202027A
------7A02027A0A0A0A0202020A0A0A0A0A020A0A0A0A0A0202020A0A0A0A020A0A0A0A02027A01010101010101010101010101017A02020202027A02020202020A0A7A0A0A0A02020202027A02020202027A
------7A020A7A0A0A0A0A0A020A7A7A7A7A7A7A7A7A7A7A7A7A7A020A7A7A7A7A7A7A7A7A7A7A01010101010101010101010101017A7A7A7A02027A7A7A7A7A7A7A7A7A0A027A02027A02027A02027A02027A
------7A020A7A0A0A0A0A0A020A7A02020A020A0202020A020202020A0A0A02020A0A0A02027A01010101010101010101010101010202027A020202020202020202020A02027A02027A02020202027A02027A
------7A0A0A7A0A0A0A0A02020A7A020202020A0A0A0A02020202020A0A0202020A0A0A0A027A01010101010101010101010101010202027A020202020202020202020202027A02027A02020202027A02027A
------7A020A7A7A7A7A7A7A7A7A7A7A7A7A7A7A7A7A7A7A7A7A7A7A7A7A7A7A7A7A7A7A0A0A7A01010101010101010101010101017A02027A7A7A7A7A7A7A7A7A7A7A7A7A7A7A02027A7A7A7A7A7A7A02027A
------7A02020A0A020A020202020202020202020202020202027A02020202020202020A0A027A01010101010101010101010101017A02027A020202020202020202020202020202027A02020202020202027A
------7A020202020202020202020202020202020202020202027A02020202020202020202027A01010101010101010101010101017A02027A020202020202020202020202020202027A02020202020202027A
------7A7A7A7A7A7A7A7A7A02027A7A7A7A7A7A7A7A7A7A7A7A7A02027A7A7A7A7A7A7A7A7A7A01010101010101010101010101017A02027A7A7A7A7A7A7A7A7A7A7A7A7A7A7A7A7A7A02027A7A7A7A7A7A7A
------7A020202020202020202020202020202020202020202020202020202020202020202027A01010101010101010101010101017A020202020202020202020202020202020202020202020202020202027A
------7A020202020202020202020202020202020202020202020202020202020202020202027A01010101010101010101010101017A020202020202020202020202020202020202020202020202020202027A
------7A02027A7A7A7A7A7A7A7A7A7A7A7A7A7A7A7A7A7A7A7A7A7A7A7A7A7A7A7A7A7A7A7A7A7A7A7A7A7A7A7A7A7A7A7A7A7A7A7A7A7A7A7A7A7A7A7A7A7A7A7A7A7A7A7A7A7A7A7A7A7A7A7A7A7A7A7A7A
------7A02027A02020202020202020202020202020202020202020202020202020202027A0202020202020202020202020202020202027A02020202020202020202020202020202020202020202020202027A
------7A02027A02020202020202020202020202020202020202020202020202020202027A0202020202020202020202020202020202027A02020202020202020202020202020202020202020202020202027A
------7A02027A02027A7A7A7A7A7A7A7A7A7A7A02027A7A7A7A7A7A7A7A7A7A7A7A7A7A7A02027A7A7A7A7A7A7A7A7A7A7A7A7A7A7A7A7A020202020202027A7A7A7A7A7A7A7A7A7A7A7A7A7A7A7A7A02027A
------7A02027A02020202020202020202020202020202020202020202027A02020202027A0202020202020202020202020202020202027A020202020202027A0202020202020202020202020202020202027A
------7A02027A02020202020202020202020202020202020202020202027A02020202027A0202020202020202020202020202020202027A020202020202027A0202020202020202020202020202020202027A
------7A02027A7A7A7A7A7A7A7A7A7A7A02027A02027A7A7A7A7A7A02027A02027A02027A7A7A7A7A7A7A7A7A7A7A7A7A7A7A7A7A02027A7A7A7A7A7A7A7A7A02027A7A7A7A7A7A7A7A7A7A7A7A7A7A7A7A7A
------7A0202020202020202020202020202027A020202020202027A02027A02027A02027A0202020202020202020202020202020202027A0A020202020202020202020A0A020202020202020202020202027A
------7A0202020202020202020202020202027A020202020202027A02027A02027A02027A020202020202020202020202020202020A0A7A0202020202020202020202020A0A0202020202020202020202027A
------7A02027A7A7A7A7A7A7A7A7A7A7A02027A7A7A7A7A7A02027A02027A02027A02027A7A7A02027A7A7A7A7A7A7A0202020A0A0A0A7A7A7A7A7A7A7A7A7A7A7A7A7A7A7A7A7A7A7A7A7A7A7A7A7A02027A
------7A02027A02020202020202020202020202020202027A02027A02020202027A02027A020202027A02020202027A02020A0A0A0A027A020202020202020202020A02020A0A0A020202020202027A02027A
------7A02027A02020202020202020202020202020202027A02027A02020202027A02027A020202027A02020202027A02020A0A0A02027A0A020202020202020A0A0A0202020A0A0A0202020202027A02027A
------7A02027A02027A7A7A7A7A7A7A7A7A7A7A7A7A7A7A7A02027A7A7A7A7A7A7A02027A02027A7A7A02027A02027A7A7A7A7A7A7A7A7A020A7A7A7A7A7A7A7A7A7A7A7A7A7A7A7A7A7A7A7A7A7A7A02027A
------7A02027A0202020202020202027A020202020202020202027A02027A02020202027A020202020202027A020202020A0A0A0A02027A020A0A0202020A7A0A0A02020202020A0A0A02020202020202027A
------7A02027A0202020202020202027A020202020202020202027A02027A02020202027A020202020202027A020202020A0A0A0A02027A020A0A02020A0A7A0A0202020202020A0A0A02020202020202027A
7A7A7A7A02027A7A7A7A7A7A7A7A7A7A7A02027A7A7A7A7A7A02027A02027A02027A7A7A7A7A7A7A7A7A7A7A7A7A7A7A7A7A7A7A7A0A027A7A7A7A7A7A0A0A7A0A027A7A7A7A7A7A7A7A7A7A7A7A7A7A7A7A7A
3E02020202020202020202020202020202020202020202027A02027A02027A02020202027A020202020202020202020202020A0A0A0A0202020A0A0A0A0A0A7A0A0A0A02020A0A0A0A0202020202020202027A
3E0202020202020202020202020A0A0A02020202020202027A02027A02027A02020202027A020202020202020202020202020A0A0A0A0A0202020A0A0A0A0A7A0A0A0A0A0A0A0A0A0A0202020202020202027A
7A7A7A7A02027A7A7A7A7A7A7A7A7A7A7A7A7A7A7A7A7A7A7A02027A02027A7A7A7A02027A02027A7A7A7A7A7A7A7A7A7A7A7A7A7A7A7A7A7A7A7A7A7A7A7A7A7A7A7A7A7A7A7A7A7A7A7A7A7A7A7A7A02027A
------7A02027A020202020A0A0A020A020A0202020202020202027A02027A02020202027A02020202020202020202020202020A0A0A0A0A0A0A0A0A0A0A0A0A0A0A0A0A0A0A0A0A020202020202027A02027A
------7A02027A0202020A0A0A0A0A0A0A0A0A02020202020202027A02027A02020202027A0202020202020202020202020202020A0A0A0A0A0A0A0A0A0A0A0A0A0A0A0A0A0A0A0A020202020202027A02027A
------7A02027A7A7A7A7A7A7A7A7A7A7A7A0A027A7A7A7A7A7A7A7A02027A02027A7A7A7A7A7A7A7A7A7A7A7A7A7A7A7A7A7A7A7A7A7A7A0A0A7A7A7A7A7A7A7A7A7A7A7A7A7A7A7A7A7A020202027A02027A
------7A02027A02020A0A0A0A0A0A0A0A0A0202020202020202027A02027A02020202027A0202020202020202020202020202020202027A0A0A0A0A0A0A0A7A0A0A0A0A0A0A020202027A020202027A02027A
------7A02027A020A0A0A0A0A0A0A0A0A020202020202020202027A02027A02020202027A0202020202020202020202020202020202027A020A0A0A0A0A027A02020A0A0A02020202027A020202027A02027A
------7A02027A020A7A7A7A7A7A7A7A7A7A7A7A7A7A7A7A7A7A7A7A02027A7A7A7A02027A7A7A7A7A7A7A7A7A7A7A7A7A7A7A7A7A02027A02027A7A7A02027A02027A7A7A7A7A7A02027A7A7A02027A02027A
------7A02027A020A0A0A0A0A0A0A0A0A0A0A02020202020202020202027A02020202027A0202020202020202020202020202027A02027A020202027A02027A020202020202027A020202020202027A02027A
------7A02027A0A0A0A0A0A0A0A0A0A0A0A0A0A020202020202020202027A02020202027A0202020202020202020202020202027A02027A020202027A02027A020202020202027A020202020202027A02027A
------7A02027A7A7A7A7A7A7A7A7A7A7A7A7A7A7A7A7A7A7A7A7A7A7A7A7A7A7A7A7A7A7A02027A7A7A7A7A7A7A7A7A7A7A02027A02027A7A7A02027A02027A7A7A7A7A7A02027A7A7A7A7A7A02027A02027A
------7A020A7A0A0A0A0A0A0A0A0A0A0A0A0A0A0A0A02020202020202020202020202020202027A0202020202020202027A02027A020202020202027A0202020202020202020202020202020202027A02027A
------7A020A7A0A0A0A0A0A0A0A0A0A0202020A0A0202020202020202020202020202020202027A0202020202020202027A02027A020202020202027A0202020202020202020202020202020202027A02027A
------7A020A7A7A7A7A7A7A7A7A7A7A7A7A7A02027A7A7A7A7A7A7A7A7A7A7A7A7A7A7A7A02027A7A7A7A7A7A7A7A02027A02027A7A7A7A7A7A02027A02027A7A7A7A7A7A7A7A7A7A7A7A7A7A7A7A7A02027A
------7A0202020A0A0A020202020A0A0A020202020202020202020202027A0202020202020202020202020202020202027A020202020202020202027A0202020202020202020202020202020202020202027A
------7A02020202020202020202020202020202020202020202020202027A0202020202020202020202020202020202027A020202020202020202027A0202020202020202020202020202020202020202027A
------7A7A7A7A7A7A7A7A7A7A7A7A7A7A7A7A7A7A7A7A7A7A7A7A7A7A7A7A7A7A7A7A7A7A7A7A7A7A7A7A7A7A7A7A7A7A7A7A7A7A7A7A7A7A7A7A7A7A7A7A7A7A7A7A7A7A7A7A7A7A7A7A7A7A7A7A7A7A7A7A
