64,64,31,29,0
78787878787878787878787878787878787878787878787878787878787878787878787878787878787878787878787878787878787878787878787878787878
78787878787878787878787878787878787878787878787878787878787878787878787878787878787878787878787878787878787878787878787878787878
78787878787878787878787878787878787878787878787878787878787878787878787878787878787878787878787878787878787878787878787878787878
78787878787878787878787878787878787878787878787878787878787878787878787878787878787878787878787878787878787878787878787878787878
78787878787878787878787878787878787878787878787878787878787878787878787878787878787878787878787878787878787878787878787878787878
78787878787878787878787878787878787878787878787878787878787878787878787878787878787878787878787878787878787878787878787878787878
78787878787878787878787878787878787878787878787878787878787878787878787878787878787878787878787878787878787878787878787878787878
78787878787878787878787878787878787878787878787878787878787878787878787878787878787878787878787878787878787878787878787878787878
78787878787878787878787878787878787878787878787878787878787878787878787878787878787878787878787878787878787878787878787878787878
78787878787878787882828282828282828282828282828282828282828282828282828282828282828282828282828282828282828282787878787878787878
787878787878787878820C0C0C0C0C0C0C0C0C0C0C0C0C0C0C0C0C0C0C0C0C0C0C0C0C0C0C0C0C0C0C0C0C0C0C0C0C0C0C0C0C0C0C0C82787878787878787878
787878787878787878820C0C0C0C0C0C0C0C0C0C0C0C0C0C0C0C0C0C0C0C0C0C0C0C0C0C0C0C0C0C0C0C0C0C0C0C0C0C0C0C0C0C0C0C82787878787878787878
787878787878787878820C0C0C0C0C0C0C0C0C0C0C0C0C0C0C0C0C0C0C0C0C0C0C0C0C0C0C0C0C0C0C0C0C0C0C0C0C0C0C0C0C0C0C0C82787878787878787878
787878787878787878820C0C0C0C0C0C0C0C0C0C0C0C0C0C0C0C0C0C0C0C0C0C0C0C0C0C0C0C0C0C0C0C0C0C0C0C0C0C0C0C0C0C0C0C82787878787878787878
787878787878787878820C0C0C0C0C0C0C0C0C0C0C0C0C0C0C0C0C0C0C0C0C0CFE0C0C0C0C0C0C0C0C0C0C0C0C0C0C0C0C0C0C0C0C0C82787878787878787878
787878787878787878820C0C0C0C0C0C0C0C0C0C0C0C0C0C0C0C0C0C0C0C0C0C0C0C0C0C0C0C0C0C0C0C0C0C0C0C0C0C0C0C0C0C0C0C82787878787878787878
787878787878787878820C0C0C0C0C0C0C0C0C0C0C0C0C0C0C0C0C0C0C0C0C0C0C0C0C0C0C0C0C0C0C0C0C0C0C0C0C0C0C0C0C0C0C0C82787878787878787878
787878787878787878820C0C0C0C0C0C0C0C0C0C0C0C0C0C0C0C0C0C0C0C0C0C0C0C0C0C0C0C0C0C0C0C0C0C0C0C0C0C0C0C0C0C0C0C82787878787878787878
787878787878787878820C0C0C0C0C0C0C0C0C0C0C0C0C0C0C0C0C0C8282780C0C7882820C0C0C0C0C0C0C0C0C0C0C0C0C0C0C0C0C0C82787878787878787878
787878787878787878820C0C0C0C0C0C0C0C0C0C0C0C0C0C0C0C0C0C82828247478282820C0C0C0C0C0C0C0C0C0C0C0C0C0C0C0C0C0C82787878787878787878
787878787878787878820C0C0C0C0C0C0C0C0C0C0C0C0C0C0C0C0C0C82820505050582820C0C0C0C0C0C0C0C0C0C0C0C0C0C0C0C0C0C82787878787878787878
787878787878787878820C0C0C0C0C0C0C0C0C0C0C0C0C0C0C0C0C0C82820505050582820C0C0C0C0C0C0C0C0C0C0C0C0C0C0C0C0C0C82787878787878787878
787878787878787878820C0C0C0C0C0C0C0C0C0C0C0C0C0C0C0C0C0C82820505050582820C0C0C0C0C0C0C0C0C0C0C0C0C0C0C0C0C0C82787878787878787878
787878787878787878820C0C0C0C0C0C0C0C0C0C0C0C0C0C0C0C0C0C82820505050582820C0C0C0C0C0C0C0C0C0C0C0C0C0C0C0C0C0C82787878787878787878
787878787878787878820C0C0C0C0C0C0C0C0C0C0C0C0C0C0C0C0C0C82820505050582820C0C0C0C0C0C0C0C0C0C0C0C0C0C0C0C0C0C82787878787878787878
787878787878787878820C0C0C0C0C0C0C0C0C0C0C0C0C0C0C0C0C0C82820505050582820C0C0C0C0C0C0C0C0C0C0C0C0C0C0C0C0C0C82787878787878787878
787878787878787878820C0C82828282828282828282828282820C0C82828282828282820C0C82828282828282828282828282820C0C82787878787878787878
787878787878787878820C0C0C0C0C0C0C0C0C0C0C0C0C0C0C0C0C0C82828282828282820C0C0C0C0C0C0C0C0C0C0C0C0C0C0C0C0C0C82787878787878787878
787878787878787878820C0C0C0C0C0C0C0C0C0C0C0C0C0C0C0C0C0C82820505050582820C0C0C0C0C0C0C0C0C0C0C0C0C0C0C0C0C0C82787878787878787878
787878787878787878820C0C0C0C0C0C0C0C0C0C0C0C0C0C0C0C0C0C82820505050582820C0C0C0C0C0C0C0C0C0C0C0C0C0C0C0C0C0C82787878787878787878
787878787878787878820C0C0C0C0C0C0C0C0C0C0C0C0C0C0C0C0C0C82820505050582820C0C0C0C0C0C0C0C0C0C0C0C0C0C0C0C0C0C82787878787878787878
787878787878787878820C0C0C0C0C0C0C0C0C0C0C0C0C0C0C0C0C0C82820505050582820C0C0C0C0C0C0C0C0C0C0C0C0C0C0C0C0C0C82787878787878787878
787878787878787878820C0C828282828282828282828282828282828282050505058282828282828282828282828282828282820C0C82787878787878787878
787878787878787878820C0C820C0C0C0C0C0C0C820C0C0C0C0C0C0C82820505050582820C0C0C0C0C0C0C820C0C0C0C0C0C0C820C0C82787878787878787878
787878787878787878820C0C820C0C0C0C0C0C0C820C0C0C0C0C0C0C8282820C0C8282820C0C0C0C0C0C0C820C0C0C0C0C0C0C820C0C82787878787878787878
787878787878787878820C0C820C0C0C0C0C0C0C820C0C0C0C0C0C0C8282780C0C7882820C0C0C0C0C0C0C820C0C0C0C0C0C0C820C0C82787878787878787878
787878787878787878820C0C820C0C0C0C0C0C0C820C0C0C0C0C0C0C82820C0C0C0C82820C0C0C0C0C0C0C820C0C0C0C0C0C0C820C0C82787878787878787878
787878787878787878820C0C820C0C0C0C0C0C0C820C0C0C0C0C0C0C82820C0C0C0C82820C0C0C0C0C0C0C820C0C0C0C0C0C0C820C0C82787878787878787878
787878787878787878820C0C820C0C0C0C0C0C0C820C0C0C0C0C0C0C8282780C0C7882820C0C0C0C0C0C0C820C0C0C0C0C0C0C820C0C82787878787878787878
787878787878787878820C0C820C0C0C0C0C0C0C820C0C0C0C0C0C0C82820C0C0C0C82820C0C0C0C0C0C0C820C0C0C0C0C0C0C820C0C82787878787878787878
787878787878787878820C0C820C0C82828282828282828282820C0C82820C0C0C0C82820C0C82828282828282828282820C0C820C0C82787878787878787878
787878787878787878820C0C0C0C0C0C0C0C0C0C0C0C0C0C0C0C0C0C8282780C0C7882820C0C0C0C0C0C0C0C0C0C0C0C0C0C0C0C0C0C82787878787878787878
787878787878787878820C0C0C0C0C0C0C0C0C0C0C0C0C0C0C0C0C0C82820C0C0C0C82820C0C0C0C0C0C0C0C0C0C0C0C0C0C0C0C0C0C82787878787878787878
78787878787878787882828282828282828282828282828282820C0C82780C0C0C0C78820C0C8282828282828282828282828282828282787878787878787878
787878787878787878820C0C0C0C0C0C0C0C0C0C0C0C0C0C0C0C0C0C820C0C0C0C0C0C820C0C0C0C0C0C0C0C0C0C0C0C0C0C0C0C0C0C82787878787878787878
787878787878787878820C0C0C0C0C0C0C0C0C0C0C0C0C0C0C0C0C0C820C0C0C0C0C0C820C0C0C0C0C0C0C0C0C0C0C0C0C0C0C0C0C0C82787878787878787878
787878787878787878820C0C82828282828282828282820C0C820C0C82780C0C0C0C78820C0C820C0C82828282828282828282820C0C82787878787878787878
787878787878787878820C0C0C0C0C0C0C820C0C0C0C0C0C0C820C0C820C0C0C0C0C0C820C0C820C0C0C0C0C0C0C820C0C0C0C0C0C0C82787878787878787878
787878787878787878820C0C0C0C0C0C0C820C0C0C0C0C0C0C820C0C820C0C0C0C0C0C820C0C820C0C0C0C0C0C0C820C0C0C0C0C0C0C82787878787878787878
787878787878787878820C0C0C0C0C0C0C820C0C0C0C0C0C0C820C0C82780C0C0C0C78820C0C820C0C0C0C0C0C0C820C0C0C0C0C0C0C82787878787878787878
787878787878787878820C0C0C0C0C0C0C820C0C0C0C0C0C0C820C0C0C0C0C0C0C0C0C0C0C0C820C0C0C0C0C0C0C820C0C0C0C0C0C0C82787878787878787878
787878787878787878820C0C0C0C0C0C0C820C0C0C0C0C0C0C820C0C0C0C0C0C0C0C0C0C0C0C820C0C0C0C0C0C0C820C0C0C0C0C0C0C82787878787878787878
787878787878787878820C0C0C0C0C0C0C820C0C0C0C0C0C0C820C0C0C0C0C0C0C0C0C0C0C0C820C0C0C0C0C0C0C820C0C0C0C0C0C0C82787878787878787878
787878787878787878820C0C0C0C0C0C0C820C0C0C0C0C0C0C820C0C0C0C0C0C0C0C0C0C0C0C820C0C0C0C0C0C0C820C0C0C0C0C0C0C82787878787878787878
78787878787878787882828282828282828282828282828282828282828282828282828282828282828282828282828282828282828282787878787878787878
78787878787878787878787878787878787878787878787878787878787878787878787878787878787878787878787878787878787878787878787878787878
78787878787878787878787878787878787878787878787878787878787878787878787878787878787878787878787878787878787878787878787878787878
78787878787878787878787878787878787878787878787878787878787878787878787878787878787878787878787878787878787878787878787878787878
78787878787878787878787878787878787878787878787878787878787878787878787878787878787878787878787878787878787878787878787878787878
78787878787878787878787878787878787878787878787878787878787878787878787878787878787878787878787878787878787878787878787878787878
78787878787878787878787878787878787878787878787878787878787878787878787878787878787878787878787878787878787878787878787878787878
78787878787878787878787878787878787878787878787878787878787878787878787878787878787878787878787878787878787878787878787878787878
78787878787878787878787878787878787878787878787878787878787878787878787878787878787878787878787878787878787878787878787878787878
78787878787878787878787878787878787878787878787878787878787878787878787878787878787878787878787878787878787878787878787878787878
