64,64,31,24,0
78787878787878787878787878787878787878787878787878787878787878787878787878787878787878787878787878787878787878787878787878787878
78787878787878787878787878787878787878787878787878787878787878787878787878787878787878787878787878787878787878787878787878787878
78787878787878787878787878787878787878787878787878787878787878787878787878787878787878787878787878787878787878787878787878787878
78787878787878787878787878787878787878787878787878787878787878787878787878787878787878787878787878787878787878787878787878787878
78787878787878787878787878787878787878787878787878787878787878787878787878787878787878787878787878787878787878787878787878787878
78787878787878787878787878787878787878787878787878787878787878787878787878787878787878787878787878787878787878787878787878787878
78787878787878787878787878787878787878787878787878787878787878787878787878787878787878787878787878787878787878787878787878787878
78787878787878787878787878787878787878787878787878787878787878787878787878787878787878787878787878787878787878787878787878787878
78787878787878787878787878787878787878787878787878787878787878787878787878787878787878787878787878787878787878787878787878787878
78787878787878787878787878787878787878787878787878787878787878787878787878787878787878787878787878787878787878787878787878787878
78787878787878787878787878787878787878787878787878787878787878787878787878787878787878787878787878787878787878787878787878787878
78787878787878787878787878787878787878787878787878787878787878787878787878787878787878787878787878787878787878787878787878787878
78787878787878787878787878787878787878787878787878787878787878787878787878787878787878787878787878787878787878787878787878787878
78787878787878787878787878787878787878787878787878787878787878787878787878787878787878787878787878787878787878787878787878787878
78787878787878787878787878787878787878787878787878787878787878787878787878787878787878787878787878787878787878787878787878787878
78787878787878787878787878787878787878787878787878787878787878787878787878787878787878787878787878787878787878787878787878787878
78787878787878787878787878787878787878787878787878787878787878787878787878787878787878787878787878787878787878787878787878787878
78787878787878787878787878787878787878787878787878787878787878787878787878787878787878787878787878787878787878787878787878787878
7878787878787878787878787878787878780C0C0C0C0C0C0C0C0C0C82828282828282820C0C0C0C0C0C0C0C0C0C787878787878787878787878787878787878
7878787878787878787878787878787878780C0C0C0C0C0C0C0C0C0C82828282828282820C0C0C0C0C0C0C0C0C0C787878787878787878787878787878787878
7878787878787878787878787878787878780C0C0C0C0C0C0C0C0C0C82820505050582820C0C0C0C0C0C0C0C0C0C787878787878787878787878787878787878
7878787878787878787878787878787878780C0C0C0C0C0C0C0C0C0C82820505050582820C0C0C0C0C0C0C0C0C0C787878787878787878787878787878787878
7878787878787878787878787878787878780C0C0C0C0C0C0C0C0C0C82820505050582820C0C0C0C0C0C0C0C0C0C787878787878787878787878787878787878
7878787878787878787878787878787878780C0C0C0C0C0C0C0C0C0C82820505050582820C0C0C0C0C0C0C0C0C0C787878787878787878787878787878787878
7878787878787878787878787878787878780C0C0C0C0C0C0C0C0C0C82820505050582820C0C0C0C0C0C0C0C0C0C787878787878787878787878787878787878
7878787878787878787878787878787878780C0C0C0C0C0C0C0C0C0C82820505050582820C0C0C0C0C0C0C0C0C0C787878787878787878787878787878787878
7878787878787878787878787878787878780C0C0C0C0C0C0C0C0C0C8282820C0C8282820C0C0C0C0C0C0C0C0C0C787878787878787878787878787878787878
7878787878787878787878787878787878780C0C0C0C0C0C0C0C0C0C8282780C0C7882820C0C0C0C0C0C0C0C0C0C787878787878787878787878787878787878
7878787878787878787878787878787878780C0C0C0C0C0C0C0C0C0C0C0C0C0C0C0C0C0C0C0C0C0C0C0C0C0C0C0C787878787878787878787878787878787878
7878787878787878787878787878787878780C0C0C0C0C0C0C0C0C0C0C0C0C0C0C0C0C0C0C0C0C0C0C0C0C0C0C0C787878787878787878787878787878787878
7878787878787878787878787878787878780C0C0C0C0C0C0C0C0C0C0C0C780C0C780C0C0C0C0C0C0C0C0C0C0C0C787878787878787878787878787878787878
7878787878787878787878787878787878780C0C0C0C0C0C0C0C0C0C0C0C0C0C0C0C0C0C0C0C0C0C0C0C0C0C0C0C787878787878787878787878787878787878
7878787878787878787878787878787878780C0C0C0C0C0C0C0C0C0C0C0C0C0C0C0C0C0C0C0C0C0C0C0C0C0C0C0C787878787878787878787878787878787878
7878787878787878787878787878787878780C0C0C0C0C0C0C0C0C0C0C0C780C0C780C0C0C0C0C0C0C0C0C0C0C0C787878787878787878787878787878787878
7878787878787878787878787878787878780C0C0C0C0C0C0C0C0C0C0C0C0C0C0C0C0C0C0C0C0C0C0C0C0C0C0C0C787878787878787878787878787878787878
7878787878787878787878787878787878780C0C0C0C0C0C0C0C0C0C0C0C0C0C0C0C0C0C0C0C0C0C0C0C0C0C0C0C787878787878787878787878787878787878
7878787878787878787878787878787878780C0C0C0C0C0C0C0C0C0C0C0C780C0C780C0C0C0C0C0C0C0C0C0C0C0C787878787878787878787878787878787878
7878787878787878787878787878787878780C0C0C0C0C0C0C0C0C0C0C0C0C0C0C0C0C0C0C0C0C0C0C0C0C0C0C0C787878787878787878787878787878787878
7878787878787878787878787878787878780C0C0C0C0C0C0C0C0C0C0C0C0C0C0C0C0C0C0C0C0C0C0C0C0C0C0C0C787878787878787878787878787878787878
7878787878787878787878787878787878780C0C0C0C0C0C0C0C0C0C0C0303000003030C0C0C0C0C0C0C0C0C0C0C787878787878787878787878787878787878
7878787878787878787878787878787878780C0C0C0C0C0C0C0C0C0C0C0303000003030C0C0C0C0C0C0C0C0C0C0C787878787878787878787878787878787878
7878787878787878787878787878787878780C0C0C0C0C0C0C0C0C0C0C0383838383030C0C0C0C0C0C0C0C0C0C0C787878787878787878787878787878787878
7878787878787878787878787878787878780C0C0C0C0C0C0C0C0C0C0C0303030303030C0C0C0C0C0C0C0C0C0C0C787878787878787878787878787878787878
7878787878787878787878787878787878780C0C0C0C0C0C0C0C0C0C0C0303030303030C0C0C0C0C0C0C0C0C0C0C787878787878787878787878787878787878
7878787878787878787878787878787878780C0C0C0C0C0C0C0C0C0C0C0C0C0C0C0C0C0C0C0C0C0C0C0C0C0C0C0C787878787878787878787878787878787878
7878787878787878787878787878787878780C0C0C0C0C0C0C0C0C0C0C0C0C0C0C0C0C0C0C0C0C0C0C0C0C0C0C0C787878787878787878787878787878787878
78787878787878787878787878787878787878787878787878787878787878787878787878787878787878787878787878787878787878787878787878787878
78787878787878787878787878787878787878787878787878787878787878787878787878787878787878787878787878787878787878787878787878787878
78787878787878787878787878787878787878787878787878787878787878787878787878787878787878787878787878787878787878787878787878787878
78787878787878787878787878787878787878787878787878787878787878787878787878787878787878787878787878787878787878787878787878787878
78787878787878787878787878787878787878787878787878787878787878787878787878787878787878787878787878787878787878787878787878787878
78787878787878787878787878787878787878787878787878787878787878787878787878787878787878787878787878787878787878787878787878787878
78787878787878787878787878787878787878787878787878787878787878787878787878787878787878787878787878787878787878787878787878787878
78787878787878787878787878787878787878787878787878787878787878787878787878787878787878787878787878787878787878787878787878787878
78787878787878787878787878787878787878787878787878787878787878787878787878787878787878787878787878787878787878787878787878787878
78787878787878787878787878787878787878787878787878787878787878787878787878787878787878787878787878787878787878787878787878787878
78787878787878787878787878787878787878787878787878787878787878787878787878787878787878787878787878787878787878787878787878787878
78787878787878787878787878787878787878787878787878787878787878787878787878787878787878787878787878787878787878787878787878787878
78787878787878787878787878787878787878787878787878787878787878787878787878787878787878787878787878787878787878787878787878787878
78787878787878787878787878787878787878787878787878787878787878787878787878787878787878787878787878787878787878787878787878787878
78787878787878787878787878787878787878787878787878787878787878787878787878787878787878787878787878787878787878787878787878787878
78787878787878787878787878787878787878787878787878787878787878787878787878787878787878787878787878787878787878787878787878787878
78787878787878787878787878787878787878787878787878787878787878787878787878787878787878787878787878787878787878787878787878787878
78787878787878787878787878787878787878787878787878787878787878787878787878787878787878787878787878787878787878787878787878787878
